,Item_ID,Item_Name,Category,Jan_Demand,Feb_Demand,Mar_Demand,Apr_Demand,May_Demand,Jun_Demand,Jul_Demand,Aug_Demand,Sep_Demand,Oct_Demand,Nov_Demand,Dec_Demand,Total_Annual_Units,Price_Per_Unit,Total_Sales_Value,Cumulative_Sales,Cumulative_Sales_Percentage,ABC_Class,Demand_Trend,Peak_Month,Low_Month,Demand_Range,High_Low_Ratio
0,ITM_001,Surface Near,Grocery,4516,4069,4664,4653,4508,4125,4669,4210,4824,4497,4259,4782,53776,10,537760,537760,0.05015071045751798,0.05015071045751798,266,Sep_Demand,Feb_Demand,755,1.1855492720925307
1,ITM_002,Central Him,Grocery,4792,4964,4628,4660,4897,5015,4805,4686,4896,4536,4520,5054,57453,100,5745300,6283060,0.585948978814365,0.585948978814365,262,Dec_Demand,Nov_Demand,534,1.1181415904465895
2,ITM_003,Win Everyone,Apparel,61,175,38,43,15,161,224,41,387,340,70,21,1576,2,3152,6286212,0.5862429297206468,0.5862429297206468,-40,Sep_Demand,May_Demand,372,25.799982800011467
3,ITM_004,Task Save,Apparel,1145,1113,717,832,783,954,1047,894,994,978,1136,712,11305,2,22610,6308822,0.5883515052254157,0.5883515052254157,-433,Jan_Demand,Dec_Demand,433,1.6081460448294096
4,ITM_005,Hotel Teacher,Grocery,1494,2051,1400,1918,1669,1733,1695,1560,1679,1381,1591,1662,19833,10,198330,6507152,0.6068474707212494,0.6068474707212494,168,Feb_Demand,Oct_Demand,670,1.485155673532544
5,ITM_006,Special Strategy,Grocery,1786,2201,2197,2234,1948,2085,2326,1960,2299,2494,1813,2017,25360,2,50720,6557872,0.6115775436802001,0.6115775436802001,231,Oct_Demand,Jan_Demand,708,1.3964165655295826
6,ITM_007,Memory Expert,Apparel,808,531,542,851,955,782,483,859,464,454,967,468,8164,2,16328,6574200,0.613100269060203,0.613100269060203,-340,Nov_Demand,Oct_Demand,513,2.1299559002212356
7,ITM_008,About No,Toys,328,294,298,297,306,294,272,274,306,286,291,297,3543,2,7086,6581286,0.6137610990481195,0.6137610990481195,-31,Jan_Demand,Jul_Demand,56,1.205882308607268
8,ITM_009,After Finally,Grocery,1335,1601,1238,1134,1442,1551,1301,1128,1167,1353,1645,1480,16375,10,163750,6745036,0.629032184360189,0.629032184360189,145,Nov_Demand,Aug_Demand,517,1.4583333204048465
9,ITM_010,Require Goal,Electronics,82,83,74,72,83,108,80,88,76,93,85,91,1015,2,2030,6747066,0.6292214991887907,0.6292214991887907,9,Jun_Demand,Apr_Demand,36,1.4999997916666956
10,ITM_011,Water Hair,Grocery,3481,3407,3105,3339,3384,3175,3524,3643,3570,3514,3066,3087,40295,500,20147500,26894566,2.5081478584249624,2.5081478584249624,-394,Aug_Demand,Nov_Demand,577,1.1881930815779742
11,ITM_012,Yet Save,Grocery,3415,3194,3363,3188,3503,3828,3294,3647,3538,3663,3585,3352,41570,2,83140,26977706,2.515901373129362,2.515901373129362,-63,Jun_Demand,Apr_Demand,640,1.2007528193200978
12,ITM_013,Strong Thing,Electronics,277,292,311,304,282,278,336,316,296,313,309,335,3649,50,182450,27160156,2.532916393069436,2.532916393069436,58,Jul_Demand,Jan_Demand,59,1.212996346101215
13,ITM_014,Whole Interest,Apparel,469,558,587,454,377,278,624,89,301,396,251,629,5013,2,10026,27170182,2.533851403153948,2.533851403153948,160,Dec_Demand,Aug_Demand,540,7.0674149362455125
14,ITM_015,Movie Give,Toys,490,487,507,487,497,490,465,456,474,517,473,469,5812,100,581200,27751382,2.588053264426466,2.588053264426466,-21,Oct_Demand,Aug_Demand,61,1.1337719049611426
15,ITM_016,Without Write,Grocery,2829,3018,2878,2427,2987,2597,2541,2887,2792,2821,2245,2947,32969,2,65938,27817320,2.5942025457901745,2.5942025457901745,118,Feb_Demand,Nov_Demand,773,1.344320706706812
16,ITM_017,Admit Fly,Home & Kitchen,159,168,152,171,174,143,183,162,152,148,158,177,1947,10,19470,27836790,2.5960182894910964,2.5960182894910964,18,Jul_Demand,Jun_Demand,40,1.2797201902293573
17,ITM_018,Color New,Apparel,449,269,382,104,37,210,257,409,239,170,64,404,2994,10,29940,27866730,2.5988104500666287,2.5988104500666287,-45,Jan_Demand,May_Demand,412,12.135131855369767
18,ITM_019,Affect Some,Grocery,3875,3473,3437,3756,4021,3596,3812,3989,3989,3635,3857,4244,45684,100,4568400,32435130,3.0248527471027136,3.0248527471027136,369,Dec_Demand,Mar_Demand,807,1.2347977851766139
19,ITM_020,Particular Election,Apparel,148,24,235,76,268,19,123,171,162,386,157,51,1820,10,18200,32453330,3.0265500524625897,3.0265500524625897,-97,Oct_Demand,Jun_Demand,367,20.31577878116906
20,ITM_021,Scene Detail,Grocery,3320,3246,3488,3297,2719,3096,3124,2973,3264,3279,3582,2952,38340,2,76680,32530010,3.03370111702277,3.03370111702277,-368,Nov_Demand,May_Demand,863,1.3173960966627578
21,ITM_022,Road Store,Electronics,458,456,505,522,516,464,473,541,508,522,477,461,5903,500,2951500,35481510,3.308953686785051,3.308953686785051,3,Aug_Demand,Feb_Demand,85,1.1864034827543097
22,ITM_023,Hand Sea,Grocery,1510,1620,1741,1708,1432,1739,1835,2063,1718,1557,1764,1378,20065,2,40130,35521640,3.312696151845041,3.312696151845041,-132,Aug_Demand,Dec_Demand,685,1.4970972315159854
23,ITM_024,Model Traditional,Electronics,123,109,123,124,139,143,140,122,110,126,136,140,1535,10,15350,35536990,3.3141276703765845,3.3141276703765845,17,Jun_Demand,Feb_Demand,34,1.311926485144359
24,ITM_025,Get Especially,Grocery,968,1246,1270,1481,1313,1066,1480,1346,958,1152,853,1362,14495,10,144950,35681940,3.3276454952070242,3.3276454952070242,394,Apr_Demand,Nov_Demand,628,1.7362250675706323
25,ITM_026,Management Perhaps,Toys,410,375,392,406,387,390,397,433,404,396,413,444,4847,10,48470,35730410,3.332165736459397,3.332165736459397,34,Dec_Demand,Feb_Demand,69,1.1839999684266675
26,ITM_027,Program Pay,Grocery,3016,2727,2746,2880,2881,2833,2674,2667,2816,2974,2765,2956,33935,100,3393500,39123910,3.648638579247234,3.648638579247234,-60,Jan_Demand,Aug_Demand,349,1.1308586384294763
27,ITM_028,Month Trouble,Grocery,1881,2072,2399,2199,2434,2439,2860,2334,2367,2234,2120,2604,27943,50,1397150,40521060,3.778934743178581,3.778934743178581,723,Jul_Demand,Jan_Demand,979,1.5204678281740147
28,ITM_029,Ever Amount,Apparel,504,69,652,504,406,514,93,273,365,604,663,594,5241,10,52410,40573470,3.783822423063806,3.783822423063806,90,Nov_Demand,Feb_Demand,594,9.608694259609527
29,ITM_030,Best Recently,Grocery,3692,3884,3576,3927,3557,4023,3784,3709,3740,4050,3800,3953,45695,2,91390,40664860,3.792345320692325,3.792345320692325,261,Oct_Demand,May_Demand,493,1.1385999405718303
30,ITM_031,Attorney Anything,Grocery,1045,1321,1217,1313,1356,1386,949,1280,1136,767,1158,979,13907,10,139070,40803930,3.8053147853295743,3.8053147853295743,-66,Jun_Demand,Oct_Demand,619,1.80704039365006
31,ITM_032,Without Certainly,Grocery,1320,804,666,853,1307,1026,875,1005,894,1179,1077,847,11853,2,23706,40827636,3.8075255721900807,3.8075255721900807,-473,Jan_Demand,Mar_Demand,654,1.9819819522224933
32,ITM_033,Hear Leave,Grocery,2906,2662,2691,3216,2637,3068,3159,2626,3148,2786,3045,2778,34722,100,3472200,44299836,4.131337861781337,4.131337861781337,-128,Apr_Demand,Aug_Demand,590,1.2246763091215676
33,ITM_034,Fight Quickly,Apparel,981,728,654,842,638,722,691,731,717,643,788,932,9067,2,18134,44317970,4.13302901207782,4.13302901207782,-49,Jan_Demand,May_Demand,343,1.537617530758346
34,ITM_035,Record Everyone,Apparel,803,919,824,1240,1246,1022,1222,810,1258,1212,677,789,12022,100,1202200,45520170,4.245144424365882,4.245144424365882,-14,Sep_Demand,Nov_Demand,581,1.858197904605644
35,ITM_036,Standard Air,Grocery,4706,4925,4505,4755,4656,4689,4657,4697,4699,4773,4865,4631,56558,2,113116,45633286,4.255693456953119,4.255693456953119,-75,Feb_Demand,Mar_Demand,420,1.0932297423013768
36,ITM_037,Property Economy,Grocery,2574,1779,1994,2135,2258,1984,2394,2243,2376,2439,1987,2001,26164,50,1308200,46941486,4.377694274084413,4.377694274084413,-573,Jan_Demand,Feb_Demand,795,1.4468802616813925
37,ITM_038,Top Congress,Apparel,816,1080,1007,1017,1094,789,776,766,786,1036,718,1078,10963,10,109630,47051116,4.387918207414259,4.387918207414259,262,May_Demand,Nov_Demand,376,1.5236768590017151
38,ITM_039,Where Difficult,Grocery,4560,4593,4992,4782,4794,4821,4449,4386,4419,4854,4568,4530,55748,2,111496,47162612,4.39831616117276,4.39831616117276,-30,Mar_Demand,Aug_Demand,606,1.138166892069843
39,ITM_040,Occur Anything,Grocery,1826,1618,1858,1519,1936,1626,1470,1743,2323,1612,2023,1443,20997,2,41994,47204606,4.402232460144332,4.402232460144332,-383,Sep_Demand,Dec_Demand,880,1.6098405986844033
40,ITM_041,Allow Land,Grocery,1978,1771,1497,1877,2137,1921,1911,1981,1917,1786,2055,1775,22606,100,2260600,49465206,4.613052707206712,4.613052707206712,-203,May_Demand,Mar_Demand,640,1.4275217005509573
41,ITM_042,Understand Special,Apparel,435,441,603,738,913,961,423,696,494,679,499,596,7478,10,74780,49539986,4.620026580548004,4.620026580548004,161,Jun_Demand,Jul_Demand,538,2.2718675585846912
42,ITM_043,Loss Nation,Toys,233,251,244,262,255,254,233,263,258,285,241,258,3037,2,6074,49546060,4.6205930328972284,4.6205930328972284,25,Oct_Demand,Jan_Demand,52,1.2231759131684157
43,ITM_044,Task Action,Grocery,3805,4042,3563,3915,3966,4032,3937,4058,4350,3882,3893,3639,47082,10,470820,50016880,4.664501016937709,4.664501016937709,-166,Sep_Demand,Mar_Demand,787,1.2208812763938217
44,ITM_045,Most Better,Grocery,2130,2437,2216,2691,2284,2608,2705,2640,2471,2424,2578,2626,29810,50,1490500,51507380,4.803502865228639,4.803502865228639,496,Jul_Demand,Jan_Demand,575,1.2699530456809716
45,ITM_046,Ahead Successful,Grocery,3357,3753,3193,3244,3456,3278,3744,3211,3311,3462,3587,3616,41212,10,412120,51919500,4.841936573190838,4.841936573190838,259,Feb_Demand,Mar_Demand,560,1.1753836480570508
46,ITM_047,Suffer Short,Apparel,734,1086,877,774,559,813,730,808,596,786,1107,906,9776,100,977600,52897100,4.933106118235597,4.933106118235597,172,Nov_Demand,May_Demand,548,1.9803219681516644
47,ITM_048,Group Important,Apparel,505,723,214,694,422,439,743,254,231,486,660,749,6120,2,12240,52909340,4.934247602719382,4.934247602719382,244,Dec_Demand,Mar_Demand,535,3.499999836448606
48,ITM_049,Figure Machine,Apparel,822,729,1175,1199,948,1087,768,751,1073,728,1039,849,11168,50,558400,53467740,4.986323169365242,4.986323169365242,27,Apr_Demand,Oct_Demand,471,1.6469779993546978
49,ITM_050,Apply Trouble,Apparel,668,845,1008,1202,1015,992,959,727,903,1233,804,1214,11570,10,115700,53583440,4.9971131820101675,4.9971131820101675,546,Oct_Demand,Jan_Demand,565,1.8458083556016713
50,ITM_051,Understand Feel,Apparel,674,450,217,597,373,455,720,300,319,489,422,227,5243,10,52430,53635870,5.002002727066118,5.002002727066118,-447,Jul_Demand,Mar_Demand,503,3.31797219732847
51,ITM_052,From Big,Home & Kitchen,186,191,201,196,192,205,185,209,194,193,189,180,2321,10,23210,53659080,5.00416725769264,5.00416725769264,-6,Aug_Demand,Dec_Demand,29,1.161111046604942
52,ITM_053,Early Best,Grocery,1321,1171,1390,972,1224,1652,1333,995,1003,991,1269,1595,14916,2,29832,53688912,5.006949346346256,5.006949346346256,274,Jun_Demand,Apr_Demand,680,1.6995884598807771
53,ITM_054,Five Work,Electronics,403,394,399,386,396,432,376,386,382,353,398,353,4658,10,46580,53735492,5.011293328965103,5.011293328965103,-50,Jun_Demand,Oct_Demand,79,1.2237959993258924
54,ITM_055,Phone Section,Apparel,52,383,4,39,431,374,372,60,126,108,393,462,2804,2,5608,53741100,5.011816322836432,5.011816322836432,410,Dec_Demand,Mar_Demand,458,115.49971125072189
55,ITM_056,Reach Garden,Apparel,1190,1200,1197,684,761,937,669,1002,994,1053,943,692,11322,2,22644,53763744,5.013928069131434,5.013928069131434,-498,Feb_Demand,Jul_Demand,531,1.7937219462821832
56,ITM_057,Plan Town,Apparel,639,816,688,689,851,997,726,746,647,793,1122,1014,9728,50,486400,54250144,5.059289021166797,5.059289021166797,375,Nov_Demand,Jan_Demand,483,1.7558685171225585
57,ITM_058,Onto Partner,Toys,254,243,222,235,251,226,222,239,239,238,228,253,2850,100,285000,54535144,5.085867704000017,5.085867704000017,-1,Jan_Demand,Mar_Demand,32,1.144144092606122
58,ITM_059,Sort Television,Electronics,392,371,359,392,398,378,361,386,399,365,403,369,4573,50,228650,54763794,5.107191268315161,5.107191268315161,-23,Nov_Demand,Mar_Demand,44,1.1225626428255533
59,ITM_060,First Beautiful,Grocery,1268,1565,1676,1221,1234,1228,1535,1744,1455,1342,1461,1494,17223,2,34446,54798240,5.110403651855066,5.110403651855066,226,Aug_Demand,Apr_Demand,523,1.4283374166393332
60,ITM_061,There Others,Apparel,254,20,308,399,156,193,213,404,521,311,540,489,3808,2,7616,54805856,5.111113908867199,5.111113908867199,235,Nov_Demand,Feb_Demand,520,26.999986500006752
61,ITM_062,Picture Forward,Grocery,1413,1642,1571,1684,1569,1954,1409,1750,1685,1718,1676,1742,19813,2,39626,54845482,5.114809371624915,5.114809371624915,329,Jun_Demand,Jul_Demand,545,1.3867991384897151
62,ITM_063,Meet Place,Electronics,260,278,254,263,280,283,268,283,254,245,261,241,3170,100,317000,55162482,5.144372327618357,5.144372327618357,-19,Jun_Demand,Dec_Demand,42,1.1742738101961074
63,ITM_064,Laugh Carry,Electronics,299,281,278,344,308,281,300,309,307,307,283,283,3580,100,358000,55520482,5.177758883598332,5.177758883598332,-16,Apr_Demand,Mar_Demand,66,1.237410027431294
64,ITM_065,My Protect,Apparel,368,327,9,32,282,82,29,406,89,76,129,183,2012,50,100600,55621082,5.1871406923457775,5.1871406923457775,-185,Aug_Demand,Mar_Demand,397,45.11106098771002
65,ITM_066,Brother Popular,Apparel,938,902,1039,1056,787,1016,1112,945,976,1073,1178,625,11647,10,116470,55737552,5.198002514063621,5.198002514063621,-313,Nov_Demand,Dec_Demand,553,1.8847999698432005
66,ITM_067,Role Statement,Home & Kitchen,442,494,451,458,468,446,459,439,466,499,497,476,5595,10,55950,55793502,5.203220329167195,5.203220329167195,34,Oct_Demand,Aug_Demand,60,1.1366742337887419
67,ITM_068,Allow Those,Apparel,1022,1119,744,872,858,697,847,879,827,735,834,1219,10653,50,532650,56326152,5.25289448850444,5.25289448850444,197,Dec_Demand,Jun_Demand,522,1.7489239347356682
68,ITM_069,Total When,Electronics,484,492,454,466,453,496,437,490,487,501,517,440,5717,10,57170,56383322,5.258226079022248,5.258226079022248,-44,Nov_Demand,Jul_Demand,80,1.1830663344836079
69,ITM_070,Defense Seat,Grocery,3085,3240,3287,2756,3255,3514,3517,3004,3307,3190,3135,3303,38593,50,1929650,58312972,5.438182413510401,5.438182413510401,218,Jul_Demand,Apr_Demand,761,1.2761248139472974
70,ITM_071,Past Building,Apparel,870,660,796,491,629,624,706,456,920,683,451,474,7760,2,15520,58328492,5.439629785993109,5.439629785993109,-396,Sep_Demand,Nov_Demand,469,2.039911262973143
71,ITM_072,Boy A,Grocery,4906,4568,4784,4726,4838,4423,4877,5036,4633,4617,4824,4599,56831,100,5683100,64011592,5.969627373394776,5.969627373394776,-307,Aug_Demand,Jun_Demand,613,1.1385937120990421
72,ITM_073,Would Speak,Home & Kitchen,283,279,257,294,299,295,267,288,283,302,279,306,3432,2,6864,64018456,5.970267499987643,5.970267499987643,23,Dec_Demand,Mar_Demand,49,1.1906614322699833
73,ITM_074,Tax Create,Apparel,430,624,281,490,638,522,498,482,289,472,333,247,5306,10,53060,64071516,5.975215797921435,5.975215797921435,-183,May_Demand,Dec_Demand,391,2.5829958468422736
74,ITM_075,Might Every,Electronics,485,507,536,524,504,485,492,529,493,488,481,468,5992,2,11984,64083500,5.976333408219938,5.976333408219938,-17,Mar_Demand,Dec_Demand,68,1.1452991208269419
75,ITM_076,Born Property,Apparel,786,542,622,532,693,1093,885,648,667,677,1033,1101,9279,2,18558,64102058,5.978064100135794,5.978064100135794,315,Dec_Demand,Apr_Demand,569,2.0695488332791574
76,ITM_077,Tough Stay,Grocery,3467,3364,3572,3208,3686,3264,3349,3554,3293,3594,3750,3368,41469,50,2073450,66175508,6.171431012137692,6.171431012137692,-99,Nov_Demand,Apr_Demand,542,1.168952614809998
77,ITM_078,Benefit West,Apparel,476,357,176,304,119,172,499,148,270,236,585,635,3977,100,397700,66573208,6.208519932007066,6.208519932007066,159,Dec_Demand,May_Demand,516,5.33613400536689
78,ITM_079,Show Performance,Apparel,1109,805,869,619,676,724,822,604,974,756,689,784,9431,50,471550,67044758,6.252495994779014,6.252495994779014,-325,Jan_Demand,Aug_Demand,505,1.8360926848329027
79,ITM_080,Thank Determine,Grocery,1745,1349,1730,1705,1643,1418,1355,1623,1641,1763,1812,1729,19513,100,1951300,68996058,6.43447137657713,6.43447137657713,-16,Nov_Demand,Feb_Demand,463,1.3432171879672559
80,ITM_081,Across Artist,Home & Kitchen,44,42,45,50,56,51,50,47,50,47,50,49,581,10,5810,69001868,6.435013208672783,6.435013208672783,5,May_Demand,Feb_Demand,14,1.3333330158730914
81,ITM_082,Spring Believe,Apparel,132,134,467,375,443,346,81,92,269,113,216,460,3128,10,31280,69033148,6.437930335686899,6.437930335686899,328,Mar_Demand,Jul_Demand,386,5.765431386983779
82,ITM_083,Community Marriage,Apparel,281,203,28,408,266,33,12,116,128,430,253,84,2242,2,4484,69037632,6.438348506963475,6.438348506963475,-197,Oct_Demand,Jul_Demand,418,35.83330347224711
83,ITM_084,Maintain Leader,Toys,274,280,302,269,276,295,285,288,270,277,270,285,3371,50,168550,69206182,6.454067233249578,6.454067233249578,11,Mar_Demand,Apr_Demand,33,1.1226765381904633
84,ITM_085,Learn Significant,Apparel,970,676,515,1056,1046,728,560,929,947,859,844,812,9942,2,19884,69226066,6.455921585984511,6.455921585984511,-158,Apr_Demand,Mar_Demand,541,2.0504853970779537
85,ITM_086,Part Treatment,Grocery,1226,1079,1142,844,943,1385,1037,553,1119,837,1324,1177,12666,2,25332,69251398,6.45828401122497,6.45828401122497,-49,Jun_Demand,Aug_Demand,832,2.50452075037033
86,ITM_087,Dark Character,Grocery,2091,2013,1971,1823,1790,2012,2012,2150,2303,2379,2013,1836,24393,50,1219650,70471048,6.572026784970715,6.572026784970715,-255,Oct_Demand,May_Demand,589,1.329050271904747
87,ITM_088,Organization Step,Grocery,3635,3993,3793,3996,3632,3837,3815,3841,3602,3873,3675,3554,45246,100,4524600,74995648,6.993984358118748,6.993984358118748,-81,Apr_Demand,Dec_Demand,442,1.1243669073596878
88,ITM_089,Mother Pass,Grocery,3998,4324,4433,4439,4103,4373,4292,4281,4142,4209,3973,4377,50944,10,509440,75505088,7.04149398682947,7.04149398682947,379,Apr_Demand,Nov_Demand,466,1.11729171629174
89,ITM_090,Rich Its,Home & Kitchen,355,409,363,361,380,416,401,380,387,414,389,382,4637,2,9274,75514362,7.042358866494717,7.042358866494717,27,Jun_Demand,Jan_Demand,61,1.1718309529061703
90,ITM_091,Several Run,Apparel,191,313,448,69,336,42,105,73,258,115,613,77,2640,10,26400,75540762,7.0448208918518995,7.0448208918518995,-114,Nov_Demand,Jun_Demand,571,14.595234620182232
91,ITM_092,Production Treatment,Apparel,343,226,565,683,658,326,316,389,718,358,712,597,5891,500,2945500,78486262,7.319513910396639,7.319513910396639,254,Sep_Demand,Feb_Demand,492,3.1769910098676544
92,ITM_093,Company Even,Toys,468,479,480,433,477,459,511,486,462,506,463,459,5683,2,11366,78497628,7.3205738869197345,7.3205738869197345,-9,Jul_Demand,Apr_Demand,78,1.1801385408743987
93,ITM_094,Data However,Apparel,529,725,222,211,744,695,544,404,549,764,646,534,6567,2,13134,78510762,7.3217987445349335,7.3217987445349335,5,Oct_Demand,Apr_Demand,553,3.620852908964317
94,ITM_095,Growth Yes,Grocery,2685,2636,2428,2648,2897,2651,2794,2928,2791,2813,2585,2680,32536,10,325360,78836122,7.352141341891483,7.352141341891483,-5,Aug_Demand,Mar_Demand,500,1.2059308022819983
95,ITM_096,National Air,Grocery,3122,3065,3026,3327,2953,3264,2811,2916,3337,3320,2886,3129,37156,2,74312,78910434,7.3590715702378064,7.3590715702378064,7,Sep_Demand,Jul_Demand,526,1.187122016410096
96,ITM_097,Yeah Around,Electronics,309,289,353,330,307,321,306,340,320,337,347,298,3857,10,38570,78949004,7.362668551981236,7.362668551981236,-11,Mar_Demand,Feb_Demand,64,1.2214532449324138
97,ITM_098,Whether Sell,Grocery,3989,4025,3564,4293,3449,3661,3692,4119,3358,3507,3384,3915,44956,2,89912,79038916,7.371053613493167,7.371053613493167,-74,Apr_Demand,Sep_Demand,935,1.2784395435424671
98,ITM_099,Specific Work,Grocery,4708,4490,4114,4660,4199,4482,4714,4624,4188,4421,4475,4768,53843,10,538430,79577346,7.421266807169977,7.421266807169977,60,Dec_Demand,Mar_Demand,654,1.158969370055981
99,ITM_100,Military Understand,Grocery,3898,3208,3882,3726,3453,3710,3201,3862,3544,3562,3839,3977,43862,500,21931000,101508346,9.466519765820355,9.466519765820355,79,Dec_Demand,Jul_Demand,776,1.2424242385428794
100,ITM_101,Charge Rest,Grocery,3995,4254,4061,3793,3795,4204,4086,3804,4038,4122,4082,4168,48402,2,96804,101605150,9.475547565164169,9.475547565164169,173,Feb_Demand,Apr_Demand,461,1.1215396753979971
101,ITM_102,Marriage Throw,Grocery,944,1004,999,1035,1503,1066,1103,1484,1233,1216,1070,848,13505,100,1350500,102955650,9.601493218379131,9.601493218379131,-96,May_Demand,Dec_Demand,655,1.7724056394763485
102,ITM_103,Seven Mother,Apparel,258,527,640,448,729,813,393,221,588,428,252,507,5804,100,580400,103536050,9.655620472822644,9.655620472822644,249,Jun_Demand,Aug_Demand,592,3.678732865215707
103,ITM_104,White Itself,Grocery,3140,3233,2908,3515,2733,3111,2801,3323,3108,3238,3031,3170,37311,2,74622,103610672,9.662579611315207,9.662579611315207,30,Apr_Demand,May_Demand,782,1.2861324504715241
104,ITM_105,Last Many,Home & Kitchen,286,255,287,280,232,266,247,269,251,247,241,257,3118,10,31180,103641852,9.665487412475699,9.665487412475699,-29,Mar_Demand,May_Demand,55,1.2370689121953056
105,ITM_106,Say Base,Electronics,379,347,355,373,360,353,389,375,391,352,378,403,4455,10,44550,103686402,9.669642080265943,9.669642080265943,24,Dec_Demand,Feb_Demand,56,1.1613832518333358
106,ITM_107,Home Open,Grocery,1450,1596,1694,1678,1404,1495,1304,1712,1697,1301,1735,1734,18800,50,940000,104626402,9.757305104347443,9.757305104347443,284,Nov_Demand,Oct_Demand,434,1.3335895362521941
107,ITM_108,Occur Food,Home & Kitchen,225,227,217,236,220,221,240,245,228,260,239,217,2775,2,5550,104631952,9.75782268922367,9.75782268922367,-8,Oct_Demand,Mar_Demand,43,1.1981566268130586
108,ITM_109,Two How,Grocery,1470,1807,1718,1748,2132,1966,1868,1479,1711,1590,2017,1666,21172,2,42344,104674296,9.761771628682931,9.761771628682931,196,May_Demand,Jan_Demand,662,1.4503401261881623
109,ITM_110,Leader Evening,Electronics,442,494,438,471,469,487,463,442,492,512,488,491,5689,10,56890,104731186,9.767077106810587,9.767077106810587,49,Oct_Demand,Mar_Demand,74,1.1689497450011475
110,ITM_111,Be Happen,Electronics,234,231,239,262,268,270,254,265,262,248,245,275,3053,10,30530,104761716,9.76992428992251,9.76992428992251,41,Dec_Demand,Feb_Demand,44,1.1904761389404268
111,ITM_112,Artist It,Home & Kitchen,111,119,85,102,95,97,101,113,101,87,95,80,1186,2,2372,104764088,9.770145499170512,9.770145499170512,-31,Feb_Demand,Dec_Demand,39,1.487499814062523
112,ITM_113,More Than,Grocery,2078,2624,1847,1914,2205,2348,2204,2247,2026,2528,1876,1925,25822,10,258220,105022308,9.794226718402772,9.794226718402772,-153,Feb_Demand,Mar_Demand,777,1.4206821796389704
113,ITM_114,Level Everything,Home & Kitchen,154,173,162,157,157,165,137,165,157,163,156,180,1926,50,96300,105118608,9.803207515444313,9.803207515444313,26,Dec_Demand,Jul_Demand,43,1.3138685172358746
114,ITM_115,Few Think,Apparel,781,701,684,511,705,718,717,467,618,481,630,866,7879,1000,7879000,112997608,10.537991522612538,10.537991522612538,85,Dec_Demand,Aug_Demand,399,1.8543896819188506
115,ITM_116,Customer Stage,Apparel,35,330,19,405,345,286,280,104,153,209,12,181,2359,10,23590,113021198,10.540191491482839,10.540191491482839,146,Apr_Demand,Nov_Demand,393,33.74997187502344
116,ITM_117,Hotel Last,Electronics,399,397,375,383,381,406,370,399,371,408,399,437,4725,10,47250,113068448,10.544597957320978,10.544597957320978,38,Dec_Demand,Jul_Demand,67,1.1810810491599717
117,ITM_118,List Long,Grocery,4459,4665,4334,4494,4528,4418,4052,4327,4209,4185,4276,4456,52403,10,524030,113592478,10.593468228075688,10.593468228075688,-3,Feb_Demand,Jul_Demand,613,1.151283314039281
118,ITM_119,Picture Yard,Apparel,504,550,492,276,276,30,510,548,306,320,586,26,4424,10,44240,113636718,10.597593985719694,10.597593985719694,-478,Nov_Demand,Dec_Demand,560,22.538452869825818
119,ITM_120,Us Benefit,Toys,234,297,242,226,270,246,232,231,246,233,259,234,2950,2,5900,113642618,10.598144211083609,10.598144211083609,0,Feb_Demand,Apr_Demand,71,1.3141592338867596
120,ITM_121,Nearly Travel,Toys,343,357,337,303,363,332,344,342,316,327,296,352,4012,10,40120,113682738,10.601885743558237,10.601885743558237,9,May_Demand,Nov_Demand,67,1.2263513099205638
121,ITM_122,Alone National,Grocery,2947,3353,3242,3432,2937,3609,2941,2672,3198,3486,3199,2806,37822,10,378220,114060958,10.637157987141327,10.637157987141327,-141,Jun_Demand,Aug_Demand,937,1.3506736476396943
122,ITM_123,One Concern,Toys,265,246,216,273,275,271,262,257,269,248,253,234,3069,10,30690,114091648,10.640020091619052,10.640020091619052,-31,May_Demand,Mar_Demand,59,1.273148089206107
123,ITM_124,Issue Country,Grocery,2824,3453,3313,3313,3285,3517,3369,3207,3378,3310,3397,3576,39942,100,3994200,118085848,11.012513337136417,11.012513337136417,752,Dec_Demand,Jan_Demand,752,1.2662889473573338
124,ITM_125,Difficult Rule,Apparel,503,883,678,497,684,676,796,774,901,629,654,796,8471,100,847100,118932948,11.091512643199648,11.091512643199648,293,Sep_Demand,Apr_Demand,404,1.8128772271050861
125,ITM_126,Summer Feel,Electronics,161,148,137,115,133,117,161,133,146,137,138,152,1678,2,3356,118936304,11.091825618847327,11.091825618847327,-9,Jan_Demand,Apr_Demand,46,1.39999987826088
126,ITM_127,Participant Represent,Grocery,4542,4376,4689,3943,4014,4200,3841,4184,3605,4406,4250,4020,50070,2,100140,119036444,11.101164528668093,11.101164528668093,-522,Mar_Demand,Sep_Demand,1084,1.3006934776679793
127,ITM_128,Anyone Able,Grocery,4944,4812,4748,4933,5011,4735,4820,4859,4830,4762,4850,4712,58016,2,116032,119152476,11.111985503147055,11.111985503147055,-232,May_Demand,Dec_Demand,299,1.0634550062320565
128,ITM_129,Business Since,Apparel,941,946,1038,769,710,757,618,892,715,1012,1059,1057,10514,100,1051400,120203876,11.210037528167575,11.210037528167575,116,Nov_Demand,Jul_Demand,441,1.7135922052816797
129,ITM_130,Practice Mean,Grocery,1439,2100,1883,1764,1910,2112,1715,1932,1876,1700,2009,1794,22234,50,1111700,121315576,11.313713042924386,11.313713042924386,355,Jun_Demand,Jan_Demand,673,1.467685882781891
130,ITM_131,Evidence Most,Electronics,151,159,163,134,174,157,151,155,168,125,144,155,1836,100,183600,121499176,11.330835310181156,11.330835310181156,4,May_Demand,Oct_Demand,49,1.391999888640009
131,ITM_132,Dream Moment,Grocery,2456,2535,2720,2627,2927,2549,2568,2114,2630,2653,2467,2664,30910,100,3091000,124590176,11.619097445751276,11.619097445751276,208,May_Demand,Aug_Demand,813,1.384578990612209
132,ITM_133,Develop Rather,Toys,356,332,355,301,317,335,333,318,314,307,345,346,3959,2,7918,124598094,11.619835866841358,11.619835866841358,-10,Jan_Demand,Apr_Demand,55,1.1827242131985312
133,ITM_134,Student Within,Grocery,3122,3209,3264,2792,3058,2758,2843,2844,2851,3114,2887,2891,35633,2,71266,124669360,11.626482029686244,11.626482029686244,-231,Mar_Demand,Jun_Demand,506,1.1834662756219496
134,ITM_135,Sort Wide,Toys,100,105,111,113,115,109,114,108,105,95,117,117,1309,10,13090,124682450,11.627702783925846,11.627702783925846,17,Nov_Demand,Oct_Demand,22,1.2315788177285454
135,ITM_136,Case Attention,Grocery,3121,3255,3259,2981,3442,3125,3206,3205,3553,3376,2848,2879,38250,2,76500,124758950,11.6348370619495,11.6348370619495,-242,Sep_Demand,Nov_Demand,705,1.247542130451046
136,ITM_137,Letter Television,Home & Kitchen,263,266,297,260,294,295,261,270,251,266,275,257,3255,10,32550,124791500,11.637872627304663,11.637872627304663,-6,Mar_Demand,Sep_Demand,46,1.1832668851288093
137,ITM_138,Result Learn,Grocery,2088,2252,2051,2118,2364,2132,2302,2490,2233,2306,2288,2514,27138,10,271380,125062880,11.663181128874065,11.663181128874065,426,Dec_Demand,Mar_Demand,463,1.2257435337603921
138,ITM_139,Piece Garden,Toys,383,348,382,391,377,376,385,347,406,377,353,384,4509,50,225450,125288330,11.684206265873186,11.684206265873186,1,Sep_Demand,Aug_Demand,59,1.1700287847253954
139,ITM_140,Top Inside,Electronics,255,265,304,284,281,315,264,244,316,227,277,298,3330,2,6660,125294990,11.684827367724656,11.684827367724656,43,Sep_Demand,Oct_Demand,89,1.3920704232568095
140,ITM_141,Heavy Who,Electronics,286,268,275,268,275,277,293,245,287,271,258,294,3297,2,6594,125301584,11.685442314512734,11.685442314512734,8,Dec_Demand,Aug_Demand,49,1.1999999510204102
141,ITM_142,Fact Car,Toys,110,105,112,101,94,93,107,101,92,97,94,103,1209,2,2418,125304002,11.685667813653405,11.685667813653405,-7,Mar_Demand,Sep_Demand,20,1.2173911720226986
142,ITM_143,Half Full,Apparel,1032,615,505,709,936,884,552,904,639,1030,787,753,9346,10,93460,125397462,11.694383756451975,11.694383756451975,-279,Jan_Demand,Mar_Demand,527,2.0435643159690238
143,ITM_144,Research Born,Grocery,3109,3079,3148,3197,3623,3402,3442,3158,2983,3249,3148,3457,38995,100,3899500,129296962,12.058045418585811,12.058045418585811,348,May_Demand,Sep_Demand,640,1.2145491075610153
144,ITM_145,But Affect,Grocery,2684,3070,2806,2987,2678,3099,2892,2834,2920,2855,2863,3263,34951,10,349510,129646472,12.090640209592964,12.090640209592964,579,Dec_Demand,May_Demand,585,1.2184465973919096
145,ITM_146,Nothing Instead,Apparel,356,476,548,248,636,267,768,460,509,719,840,644,6471,2,12942,129659414,12.091847161569202,12.091847161569202,288,Nov_Demand,Apr_Demand,592,3.387096637617071
146,ITM_147,Hair Good,Grocery,4215,4896,4536,4629,4373,4948,4446,4077,4552,4211,4274,4200,53357,10,533570,130192984,12.141607118759802,12.141607118759802,-15,Jun_Demand,Aug_Demand,871,1.2136374755613502
147,ITM_148,Ask Four,Apparel,261,686,229,519,424,265,510,493,432,613,180,435,5047,10,50470,130243454,12.14631387708469,12.14631387708469,174,Feb_Demand,Nov_Demand,506,3.8111108993827276
148,ITM_149,Heart Kind,Toys,389,419,415,407,402,442,380,439,418,414,406,407,4938,500,2469000,132712454,12.37656920310301,12.37656920310301,18,Jun_Demand,Jul_Demand,62,1.1631578641274247
149,ITM_150,All Beat,Electronics,336,287,310,326,314,297,325,350,277,323,319,307,3771,2,7542,132719996,12.37727255898346,12.37727255898346,-29,Aug_Demand,Sep_Demand,73,1.263537860522099
150,ITM_151,Yes Human,Grocery,4208,4414,3960,3813,4008,3947,4012,3929,3971,4022,3904,3810,47998,10,479980,133199976,12.422034791216053,12.422034791216053,-398,Feb_Demand,Dec_Demand,604,1.1585301806862724
151,ITM_152,Stay Successful,Home & Kitchen,429,470,425,469,426,442,415,447,400,450,442,427,5242,500,2621000,135820976,12.666465414745424,12.666465414745424,-2,Feb_Demand,Sep_Demand,70,1.1749999706250007
152,ITM_153,Their In,Apparel,329,476,259,263,470,138,74,291,112,336,321,341,3410,2,6820,135827796,12.667101437962696,12.667101437962696,12,Feb_Demand,Jul_Demand,402,6.432431563184924
153,ITM_154,Recent City,Grocery,2778,2255,2824,3109,2539,2558,2680,2594,3005,2835,2757,2607,32541,2,65082,135892878,12.67317089001937,12.67317089001937,-171,Apr_Demand,Feb_Demand,854,1.3787139628438403
154,ITM_155,Win Cell,Electronics,399,362,404,415,374,422,383,412,387,386,424,378,4746,10,47460,135940338,12.677596940150123,12.677596940150123,-21,Nov_Demand,Feb_Demand,62,1.1712706858765005
155,ITM_156,Rest Control,Grocery,2594,2517,2810,1938,2349,2288,2138,2311,2307,2477,2543,2294,28566,10,285660,136225998,12.704237173617273,12.704237173617273,-300,Mar_Demand,Apr_Demand,872,1.4499483929311228
156,ITM_157,Attorney These,Grocery,4420,4525,3938,4375,4477,4216,4435,4532,4391,4406,4498,4201,52414,10,524140,136750138,12.753117702810972,12.753117702810972,-219,Aug_Demand,Mar_Demand,594,1.1508379859044235
157,ITM_158,One Blue,Grocery,2753,2588,2764,2963,2724,2851,2684,2710,2765,2957,2680,3265,33704,50,1685200,138435338,12.910276988111121,12.910276988111121,512,Dec_Demand,Feb_Demand,677,1.261591958030943
158,ITM_159,Land Least,Home & Kitchen,332,293,323,317,304,334,345,307,316,295,302,299,3767,2,7534,138442872,12.910979597923282,12.910979597923282,-33,Jul_Demand,Feb_Demand,52,1.1774743625435373
159,ITM_160,She I,Home & Kitchen,223,212,195,197,226,191,181,201,197,182,202,219,2426,10,24260,138467132,12.913242050012874,12.913242050012874,-4,May_Demand,Jul_Demand,45,1.2486187155459274
160,ITM_161,Will Watch,Grocery,1551,1174,1023,1262,1223,1177,1179,1029,1348,958,1190,1306,14420,10,144200,138611332,12.926689930941121,12.926689930941121,-245,Jan_Demand,Oct_Demand,593,1.6189978954175586
161,ITM_162,Us Box,Apparel,36,365,419,378,282,206,214,283,144,63,214,462,3066,2,6132,138617464,12.92726179228545,12.92726179228545,426,Dec_Demand,Jan_Demand,426,12.833329768519508
162,ITM_163,Measure Work,Grocery,5276,4885,4999,4558,4810,4857,4956,4686,5053,4956,5107,4748,58891,2,117782,138735246,12.93824596920286,12.93824596920286,-528,Jan_Demand,Apr_Demand,718,1.1575252278246486
163,ITM_164,Start Couple,Grocery,1886,1871,2209,2084,2122,2307,2174,1982,2137,2200,2395,2187,25554,2,51108,138786354,12.94301222647388,12.94301222647388,301,Nov_Demand,Feb_Demand,524,1.280064129983623
164,ITM_165,Successful Heavy,Grocery,4158,4272,4147,4005,3791,4240,4271,4020,4055,4317,3842,4581,49699,50,2484950,141271304,13.174755026145498,13.174755026145498,423,Dec_Demand,May_Demand,790,1.2083882848631275
165,ITM_166,Trouble Today,Apparel,179,328,466,300,618,233,120,475,410,110,247,299,3785,2,7570,141278874,13.175460993264961,13.175460993264961,120,May_Demand,Oct_Demand,508,5.618181307438062
166,ITM_167,History Within,Home & Kitchen,48,69,62,56,56,73,55,61,61,68,75,67,751,10,7510,141286384,13.176161364872252,13.176161364872252,19,Nov_Demand,Jan_Demand,27,1.5624996744792343
167,ITM_168,Customer Method,Electronics,146,161,152,127,140,166,150,161,193,151,154,153,1854,2,3708,141290092,13.176507167524692,13.176507167524692,7,Sep_Demand,Apr_Demand,66,1.5196849197098488
168,ITM_169,Material Vote,Grocery,4871,4994,4740,4958,4428,4889,4754,4672,4477,4544,4553,4982,56862,500,28431000,169721092,15.827940611845008,15.827940611845008,111,Feb_Demand,May_Demand,566,1.12782294234909
169,ITM_170,Action Key,Grocery,1514,1843,2114,1927,1488,1771,1514,1516,1441,1252,1794,1732,19906,10,199060,169920152,15.84650465607231,15.84650465607231,218,Mar_Demand,Oct_Demand,862,1.6884983890695018
170,ITM_171,Fear Service,Electronics,158,178,173,174,162,179,185,190,175,180,197,201,2152,500,1076000,170996152,15.94685084108475,15.94685084108475,43,Dec_Demand,Jan_Demand,43,1.2721518182182394
171,ITM_172,Social Often,Grocery,3299,3572,3571,3454,3037,3755,3183,3465,3608,3323,3241,3556,41064,10,410640,171406792,15.985146526413288,15.985146526413288,257,Jun_Demand,May_Demand,718,1.2364175132156157
172,ITM_173,Between Natural,Electronics,234,226,253,273,259,254,267,243,276,264,263,271,3083,10,30830,171437622,15.98802168708609,15.98802168708609,37,Sep_Demand,Feb_Demand,50,1.2212388840159785
173,ITM_174,Character Street,Apparel,534,858,875,487,865,520,558,665,973,545,688,650,8218,2,16436,171454058,15.989554484388009,15.989554484388009,116,Sep_Demand,Apr_Demand,486,1.997946570884054
174,ITM_175,Head Fill,Home & Kitchen,239,257,255,263,248,257,228,273,246,243,219,241,2969,10,29690,171483748,15.992323330329477,15.992323330329477,2,Aug_Demand,Nov_Demand,54,1.2465752855445076
175,ITM_176,Once Among,Home & Kitchen,228,234,239,233,218,218,244,250,227,202,246,231,2770,10,27700,171511448,15.994906591783792,15.994906591783792,3,Aug_Demand,Oct_Demand,48,1.2376237011077376
176,ITM_177,Carry Arrive,Grocery,5214,4788,4879,4769,5085,4879,4878,4885,4591,5006,4900,4860,58734,10,587340,172098788,16.049681060468927,16.049681060468927,-354,Jan_Demand,Sep_Demand,623,1.135700280688956
177,ITM_178,Investment Agreement,Electronics,63,63,59,72,55,65,60,59,59,61,75,65,756,2,1512,172100300,16.04982206737575,16.04982206737575,2,Nov_Demand,May_Demand,20,1.3636361157025243
178,ITM_179,Land Foreign,Grocery,1124,640,1113,1202,1456,1239,1199,1501,1579,970,1455,1292,14770,10,147700,172248000,16.063596353180895,16.063596353180895,168,Sep_Demand,Feb_Demand,939,2.467187461450196
179,ITM_180,Money Never,Grocery,2301,2533,2181,2241,2566,2237,2296,2207,2219,2499,1945,2658,27883,2,55766,172303766,16.068797008713798,16.068797008713798,357,Dec_Demand,Nov_Demand,713,1.3665809698376299
180,ITM_181,Tv Top,Grocery,4590,4640,4348,4525,4771,4889,4665,4640,4377,4517,4638,4592,55192,2,110384,172414150,16.079091258979982,16.079091258979982,2,Jun_Demand,Mar_Demand,541,1.124425020413006
181,ITM_182,Others Get,Toys,493,515,509,493,501,436,526,504,508,509,525,528,6047,2,12094,172426244,16.080219127717474,16.080219127717474,35,Dec_Demand,Jun_Demand,92,1.2110091465364876
182,ITM_183,Cover Brother,Grocery,1373,1797,1447,1631,1717,1642,1752,1339,1861,1729,1791,1643,19722,1000,19722000,192148244,17.919463979776328,17.919463979776328,270,Sep_Demand,Aug_Demand,522,1.3898431561624858
183,ITM_184,Me Sing,Electronics,483,441,473,484,476,469,433,463,477,464,519,459,5641,2,11282,192159526,17.920516122582377,17.920516122582377,-24,Nov_Demand,Jul_Demand,86,1.198614291025074
184,ITM_185,Land Positive,Apparel,136,248,616,705,337,367,615,288,124,194,679,369,4678,2,9356,192168882,17.921388649447596,17.921388649447596,233,Apr_Demand,Sep_Demand,581,5.685483412461015
185,ITM_186,Indeed Floor,Apparel,798,402,595,709,347,597,555,622,849,451,581,342,6848,2,13696,192182578,17.92266591836017,17.92266591836017,-456,Sep_Demand,Dec_Demand,507,2.4824560677644425
186,ITM_187,Lay Cut,Apparel,874,487,685,980,970,1018,863,468,487,704,670,791,8997,2,17994,192200572,17.924344012461578,17.924344012461578,-83,Jun_Demand,Aug_Demand,550,2.1752136287347517
187,ITM_188,Notice Remain,Electronics,134,147,137,121,115,141,142,130,138,129,140,134,1608,10,16080,192216652,17.92584360972459,17.92584360972459,0,Feb_Demand,May_Demand,32,1.278260758412108
188,ITM_189,Avoid Part,Toys,385,386,383,405,403,380,395,417,362,384,371,389,4660,50,233000,192449652,17.94757284867245,17.94757284867245,4,Aug_Demand,Sep_Demand,55,1.1519336698360865
189,ITM_190,Your While,Grocery,1520,1165,1367,1279,1338,1102,1354,1304,1263,1389,1284,1573,15938,50,796900,193246552,18.021890576215586,18.021890576215586,53,Dec_Demand,Jun_Demand,471,1.427404705740429
190,ITM_191,Soon Sell,Apparel,563,699,208,430,263,521,448,331,381,267,437,435,4983,50,249150,193495702,18.045125940523995,18.045125940523995,-128,Feb_Demand,Mar_Demand,491,3.3605767615107327
191,ITM_192,Hand Daughter,Apparel,503,264,490,209,174,311,88,611,412,82,39,395,3578,10,35780,193531482,18.048462730951268,18.048462730951268,-108,Aug_Demand,Nov_Demand,572,15.666662649573679
192,ITM_193,Appear Author,Electronics,116,130,111,109,84,101,134,105,120,100,128,130,1368,10,13680,193545162,18.049738507727263,18.049738507727263,14,Jul_Demand,May_Demand,50,1.5952379053288208
193,ITM_194,First Establish,Grocery,2690,2735,2806,2961,2653,2352,2693,3189,2801,2679,2579,2709,32847,2,65694,193610856,18.055865034008125,18.055865034008125,19,Aug_Demand,Jun_Demand,837,1.3558673411740334
194,ITM_195,Chance Benefit,Electronics,250,262,248,272,244,262,250,250,262,254,262,257,3073,100,307300,193918156,18.084523382199873,18.084523382199873,7,Apr_Demand,May_Demand,28,1.1147540526740143
195,ITM_196,Institution Others,Electronics,271,273,312,282,283,290,293,292,292,277,263,281,3409,10,34090,193952246,18.087702565700873,18.087702565700873,10,Mar_Demand,Nov_Demand,49,1.186311741965333
196,ITM_197,Stay Case,Grocery,1946,1732,2004,1927,2152,1514,1562,1984,2068,1615,1826,1784,22114,10,221140,194173386,18.108325758408725,18.108325758408725,-162,May_Demand,Jun_Demand,638,1.4214002548124158
197,ITM_198,Buy Media,Grocery,2986,3291,3494,3433,3595,3386,3468,3308,3541,3131,3269,3179,40081,100,4008100,198181486,18.482115297580062,18.482115297580062,193,May_Demand,Jan_Demand,609,1.203951770917777
198,ITM_199,Trip Sense,Apparel,615,288,281,441,274,260,381,613,560,373,544,604,5234,100,523400,198704886,18.53092681545693,18.53092681545693,-11,Jan_Demand,Jun_Demand,355,2.3653845244082876
199,ITM_200,House Away,Grocery,4309,4299,4517,4441,4203,4201,4534,4264,4442,4680,4302,4337,52529,2,105058,198809944,18.54072437075901,18.54072437075901,28,Oct_Demand,Jun_Demand,479,1.114020468664555
200,ITM_201,While Energy,Apparel,302,71,310,440,333,307,213,3,373,250,234,259,3095,2,6190,198816134,18.54130164109844,18.54130164109844,-43,Apr_Demand,Aug_Demand,437,146.6661777794074
201,ITM_202,Meet Fly,Grocery,3399,3002,3647,3619,3574,3532,3385,3411,3563,3303,3509,3693,41637,10,416370,199232504,18.580131697839732,18.580131697839732,294,Dec_Demand,Feb_Demand,691,1.230179875982079
202,ITM_203,Stage Including,Grocery,4057,3727,4223,4017,4308,4041,4104,4136,4179,3994,4087,3625,48498,50,2424900,201657404,18.80627432240912,18.80627432240912,-432,May_Demand,Dec_Demand,683,1.1884137898250653
203,ITM_204,Democratic Painting,Toys,487,507,499,497,502,503,463,496,485,480,510,479,5908,2,11816,201669220,18.807376265273533,18.807376265273533,-8,Nov_Demand,Jul_Demand,47,1.1015118552589234
204,ITM_205,Event Major,Home & Kitchen,320,292,327,278,308,293,293,306,294,262,283,301,3557,50,177850,201847070,18.823962295946824,18.823962295946824,-19,Mar_Demand,Oct_Demand,65,1.248091555416353
205,ITM_206,Baby Certain,Electronics,435,404,398,394,420,406,395,433,414,429,371,385,4884,2,9768,201856838,18.824873245328984,18.824873245328984,-50,Jan_Demand,Nov_Demand,64,1.1725067069405202
206,ITM_207,Identify Especially,Electronics,129,107,111,124,129,119,129,120,144,97,130,111,1450,50,72500,201929338,18.83163448920761,18.83163448920761,-18,Sep_Demand,Oct_Demand,47,1.4845359294292855
207,ITM_208,Area Represent,Toys,111,137,107,104,99,107,105,73,101,95,86,108,1233,2,2466,201931804,18.83186446475802,18.83186446475802,-3,Feb_Demand,Aug_Demand,64,1.8767120716832777
208,ITM_209,Wrong Strong,Grocery,3463,3295,3591,3412,2965,3681,3582,3299,3292,3596,3698,3439,41313,10,413130,202344934,18.870392363841837,18.870392363841837,-24,Nov_Demand,May_Demand,733,1.247217533736197
209,ITM_210,Position Describe,Electronics,309,306,308,332,324,311,286,300,318,323,301,326,3744,2,7488,202352422,18.87109068376133,18.87109068376133,17,Apr_Demand,Jul_Demand,46,1.1608391202503805
210,ITM_211,Fund Raise,Apparel,336,695,602,287,517,813,304,517,377,438,429,371,5686,10,56860,202409282,18.8763933641329,18.8763933641329,35,Jun_Demand,Apr_Demand,526,2.83275251453824
211,ITM_212,Range Certainly,Apparel,321,150,190,33,129,181,248,96,146,157,27,145,1823,2,3646,202412928,18.87673338475609,18.87673338475609,-176,Jan_Demand,Nov_Demand,294,11.88888448559834
212,ITM_213,Draw Clear,Grocery,5123,4889,5033,5154,4998,4705,4860,4910,4892,4770,4856,5068,59258,2,118516,202531444,18.887786013439115,18.887786013439115,-55,Apr_Demand,Jun_Demand,449,1.0954303908704988
213,ITM_214,Forward Matter,Grocery,910,1221,800,1117,1099,601,906,1272,914,1209,1263,1023,12335,10,123350,202654794,18.899289453886404,18.899289453886404,113,Aug_Demand,Jun_Demand,671,2.116472510541223
214,ITM_215,Wind Sing,Apparel,695,787,1191,1087,1114,951,794,742,1207,1232,1087,700,11587,2,23174,202677968,18.901450627205623,18.901450627205623,5,Oct_Demand,Jan_Demand,537,1.7726618449976714
215,ITM_216,Red Before,Home & Kitchen,473,438,497,491,421,489,443,473,465,491,476,465,5622,10,56220,202734188,18.906693622113988,18.906693622113988,-8,Mar_Demand,May_Demand,76,1.1805225372797499
216,ITM_217,Certain Say,Grocery,4115,4125,4670,4338,4743,4373,4398,4252,4300,4401,4395,4260,52370,10,523700,203257888,18.95553311755173,18.95553311755173,145,May_Demand,Jan_Demand,628,1.1526123908806505
217,ITM_218,Themselves Like,Grocery,2269,2740,2283,2554,2599,2716,2811,2336,2156,2470,2348,2636,29918,500,14959000,218216888,20.350587561418905,20.350587561418905,367,Jul_Demand,Sep_Demand,655,1.3038033334702999
218,ITM_219,Lay Building,Grocery,5132,5001,5044,5171,4899,4962,4896,5150,4804,4854,4874,5180,59967,100,5996700,224213588,20.90983102579074,20.90983102579074,48,Dec_Demand,Sep_Demand,376,1.0782681076638883
219,ITM_220,Specific Style,Grocery,4367,3931,4490,4466,4370,4100,4302,4069,4230,4153,4421,4079,50978,50,2548900,226762488,21.14753770885599,21.14753770885599,-288,Mar_Demand,Feb_Demand,559,1.1422029988750877
220,ITM_221,Past Somebody,Toys,71,63,74,70,73,60,63,55,64,70,77,84,824,100,82400,226844888,21.155222212243558,21.155222212243558,13,Dec_Demand,Aug_Demand,29,1.5272724495868273
221,ITM_222,Prepare Full,Home & Kitchen,330,348,266,312,324,330,278,338,333,341,335,322,3857,10,38570,226883458,21.15881919398699,21.15881919398699,-8,Feb_Demand,Mar_Demand,82,1.308270627508623
222,ITM_223,Baby Only,Grocery,2863,2740,2548,2619,2401,2815,2427,2566,2811,2522,2741,2620,31673,2,63346,226946804,21.16472674922472,21.16472674922472,-243,Jan_Demand,May_Demand,462,1.1924198201065397
223,ITM_224,Home Way,Electronics,388,399,388,429,409,419,407,443,424,402,396,461,4965,100,496500,227443304,21.211029612476278,21.211029612476278,73,Dec_Demand,Jan_Demand,73,1.1881442992746316
224,ITM_225,Commercial Author,Apparel,389,409,286,218,129,91,239,15,369,48,119,138,2450,100,245000,227688304,21.23387795385922,21.23387795385922,-251,Feb_Demand,Aug_Demand,394,27.26664848890101
225,ITM_226,These Recently,Toys,338,382,382,364,391,372,380,377,400,378,376,347,4487,2,8974,227697278,21.23471485596359,21.23471485596359,9,Sep_Demand,Jan_Demand,62,1.1834319176499433
226,ITM_227,Involve Car,Electronics,225,249,246,242,214,242,209,242,245,222,245,235,2816,2,5632,227702910,21.235240088039788,21.235240088039788,10,Feb_Demand,Jul_Demand,40,1.1913875028044256
227,ITM_228,Him Mr,Apparel,556,619,694,648,498,908,684,959,830,937,703,577,8613,500,4306500,232009410,21.63685797443019,21.63685797443019,21,Aug_Demand,May_Demand,461,1.9257027725762497
228,ITM_229,Product Clear,Electronics,165,162,163,160,182,155,175,177,161,151,184,161,1996,50,99800,232109210,21.646165176348628,21.646165176348628,-4,Nov_Demand,Oct_Demand,33,1.2185429656594062
229,ITM_230,Region Go,Apparel,478,539,454,394,300,570,566,329,137,652,655,552,5626,2,11252,232120462,21.647214521398592,21.647214521398592,74,Nov_Demand,Sep_Demand,518,4.781021548830544
230,ITM_231,Special Boy,Apparel,643,1108,741,665,1076,873,888,1004,869,1027,987,650,10531,10,105310,232225772,21.657035577851808,21.657035577851808,7,Feb_Demand,Jan_Demand,465,1.7231726015058695
231,ITM_232,Executive Ground,Electronics,372,353,335,360,344,368,355,353,333,327,342,366,4208,10,42080,232267852,21.6609598970575,21.6609598970575,-6,Jan_Demand,Oct_Demand,45,1.137614644109644
232,ITM_233,General Art,Grocery,3836,4246,3947,3464,3799,3731,3767,3810,3611,3872,3846,3972,45901,50,2295050,234562902,21.87499290069393,21.87499290069393,136,Feb_Demand,Apr_Demand,782,1.2257505738286645
233,ITM_234,Better Plant,Grocery,2533,2415,2407,2549,2563,2446,2338,2213,2535,2466,2439,2260,29164,2,58328,234621230,21.88043248459672,21.88043248459672,-273,May_Demand,Aug_Demand,350,1.1581563436142956
234,ITM_235,Type Box,Grocery,3798,4095,4051,3595,4091,3950,4129,3754,3995,4060,3613,4158,47289,2,94578,234715808,21.889252690438827,21.889252690438827,360,Dec_Demand,Apr_Demand,563,1.156606394557423
235,ITM_236,Test Whole,Apparel,244,158,316,13,403,15,481,398,399,419,279,313,3438,500,1719000,236434808,22.049564114264463,22.049564114264463,69,Jul_Demand,Apr_Demand,468,36.999971538483436
236,ITM_237,Start Concern,Apparel,549,511,104,615,308,436,631,290,51,589,603,424,5111,10,51110,236485918,22.054330558052552,22.054330558052552,-125,Jul_Demand,Sep_Demand,580,12.372546593618313
237,ITM_238,Effect Certainly,Grocery,2869,2380,2673,2364,2502,2665,2447,2453,2794,2548,2264,2734,30693,500,15346500,251832418,23.48552268471928,23.48552268471928,-135,Jan_Demand,Nov_Demand,605,1.2672261428126053
238,ITM_239,Every Successful,Apparel,616,739,832,698,844,594,858,400,516,663,766,484,8010,50,400500,252232918,23.522872728490174,23.522872728490174,-132,Jul_Demand,Aug_Demand,458,2.1449999463750014
239,ITM_240,Morning Budget,Electronics,208,162,182,182,161,177,198,194,197,197,163,177,2198,2,4396,252237314,23.52328269301556,23.52328269301556,-31,Jan_Demand,May_Demand,47,1.2919253855946966
240,ITM_241,If Picture,Apparel,574,541,645,80,398,596,323,645,478,438,310,554,5582,2,11164,252248478,23.524323831314334,23.524323831314334,-20,Mar_Demand,Apr_Demand,565,8.062498992187626
241,ITM_242,Image None,Electronics,89,88,121,87,86,111,79,107,84,98,95,100,1145,2,2290,252250768,23.524537393362362,23.524537393362362,11,Mar_Demand,Jul_Demand,42,1.5316453757410917
242,ITM_243,Character Food,Home & Kitchen,188,199,194,199,170,180,196,201,188,178,179,188,2260,2,4520,252255288,23.524958921946244,23.524958921946244,0,Aug_Demand,May_Demand,31,1.1823528716263016
243,ITM_244,Recent Expert,Grocery,2001,2706,2540,2562,2598,2447,2564,2625,2655,2658,2288,2362,30006,2,60012,252315300,23.530555553224094,23.530555553224094,361,Feb_Demand,Jan_Demand,705,1.3523238313227195
244,ITM_245,Field Blue,Home & Kitchen,139,148,163,151,134,139,136,147,139,152,146,144,1738,50,86900,252402200,23.538659720024818,23.538659720024818,5,Mar_Demand,May_Demand,29,1.216417819670312
245,ITM_246,Attack Of,Home & Kitchen,123,116,114,118,127,108,108,122,118,106,120,125,1405,50,70250,252472450,23.545211132196865,23.545211132196865,2,May_Demand,Oct_Demand,21,1.1981130945176326
246,ITM_247,Control Analysis,Apparel,459,400,704,764,712,617,355,439,476,229,557,444,6156,100,615600,253088050,23.60262108711662,23.60262108711662,-15,Apr_Demand,Oct_Demand,535,3.336244395797188
247,ITM_248,Radio Could,Apparel,814,389,460,465,246,464,342,489,462,273,383,417,5204,10,52040,253140090,23.607474261343434,23.607474261343434,-397,Jan_Demand,May_Demand,568,3.308942954921018
248,ITM_249,Will How,Grocery,3473,3864,3446,3792,3779,3659,3557,4028,3632,3593,3742,3564,44129,100,4412900,257552990,24.019014855991568,24.019014855991568,91,Aug_Demand,Mar_Demand,582,1.1688914649770996
249,ITM_250,Choose Letter,Grocery,3323,3272,3531,3242,2967,3362,3107,3330,3300,3113,2985,3466,38998,50,1949900,259502890,24.200859675838924,24.200859675838924,143,Mar_Demand,May_Demand,564,1.1900909970000302
250,ITM_251,Both Prevent,Toys,505,532,455,492,472,437,474,479,465,475,481,466,5733,2,11466,259514356,24.201928978215644,24.201928978215644,-39,Feb_Demand,Jun_Demand,95,1.2173912764899022
251,ITM_252,Dog Population,Toys,338,298,307,349,307,337,365,346,336,325,306,341,3955,10,39550,259553906,24.205617353324605,24.205617353324605,3,Jul_Demand,Feb_Demand,67,1.22483217366335
252,ITM_253,Produce Win,Grocery,3476,3942,3829,3824,3620,3628,4033,4109,3329,3807,3820,3628,45045,100,4504500,264058406,24.625700429893875,24.625700429893875,152,Aug_Demand,Sep_Demand,780,1.2343045922670333
253,ITM_254,Network Myself,Electronics,364,384,344,383,346,371,361,403,372,381,423,402,4534,10,45340,264103746,24.629928771927762,24.629928771927762,38,Nov_Demand,Mar_Demand,79,1.2296511270450254
254,ITM_255,Example Far,Apparel,259,111,346,306,82,401,29,417,248,111,61,333,2704,2,5408,264109154,24.63043311409184,24.63043311409184,74,Aug_Demand,Jul_Demand,388,14.379305386446418
255,ITM_256,Check Section,Apparel,594,300,398,523,300,474,409,681,588,652,276,504,5699,100,569900,264679054,24.683581153904655,24.683581153904655,-90,Aug_Demand,Nov_Demand,405,2.467391214949594
256,ITM_257,Movement Civil,Electronics,238,241,267,268,292,252,288,250,260,254,249,248,3107,2,6214,264685268,24.684160662448956,24.684160662448956,10,May_Demand,Jan_Demand,54,1.2268907047524913
257,ITM_258,Present Audience,Grocery,3760,4151,4221,3939,3943,3996,3789,4197,3730,4091,3772,4024,47613,10,476130,265161398,24.72856384931696,24.72856384931696,264,Mar_Demand,Sep_Demand,491,1.1316353857060713
258,ITM_259,Case Knowledge,Grocery,2776,2640,2499,2946,2737,2794,2763,2789,2689,2793,2891,2950,33267,2,66534,265227932,24.73476871276828,24.73476871276828,174,Dec_Demand,Mar_Demand,451,1.1804721841517718
259,ITM_260,Around Their,Grocery,2697,2663,2740,3121,3163,3144,2832,3005,2747,2609,2994,3030,34745,50,1737250,266965182,24.8967821048806,24.8967821048806,333,May_Demand,Oct_Demand,554,1.212341888798996
260,ITM_261,Top His,Electronics,416,456,450,451,489,456,462,444,440,447,465,479,5455,2,10910,266976092,24.897799555511163,24.897799555511163,63,May_Demand,Jan_Demand,73,1.1754807409740207
261,ITM_262,Chair Such,Apparel,536,790,886,757,594,787,703,402,727,473,793,830,8278,2,16556,266992648,24.899343543837436,24.899343543837436,294,Mar_Demand,Aug_Demand,484,2.2039800446771136
262,ITM_263,Natural Beyond,Electronics,136,127,116,138,141,128,158,123,129,144,140,141,1621,100,162100,267154748,24.91446075256468,24.91446075256468,5,Jul_Demand,Mar_Demand,42,1.3620688480975132
263,ITM_264,Pass North,Grocery,2308,2614,2583,2090,2678,2251,2824,2384,2384,2308,2180,2279,28883,100,2888300,270043048,25.183819382835523,25.183819382835523,-29,Jul_Demand,Apr_Demand,734,1.3511961657837503
264,ITM_265,Look Drop,Home & Kitchen,189,197,177,206,191,184,204,198,212,189,209,167,2323,2,4646,270047694,25.184252661994975,25.184252661994975,-22,Sep_Demand,Dec_Demand,45,1.2694610018286825
265,ITM_266,Mind Unit,Home & Kitchen,144,156,146,154,163,149,149,142,155,157,139,148,1802,100,180200,270227894,25.20105785022847,25.20105785022847,4,May_Demand,Nov_Demand,24,1.1726617861394397
266,ITM_267,Character Life,Apparel,387,481,259,394,688,473,273,318,666,617,195,588,5339,10,53390,270281284,25.206036923479225,25.206036923479225,201,May_Demand,Nov_Demand,493,3.5282049472715413
267,ITM_268,The Case,Home & Kitchen,371,319,385,345,367,336,329,353,375,390,328,324,4222,2,8444,270289728,25.20682439855938,25.20682439855938,-47,Oct_Demand,Feb_Demand,71,1.2225704945902667
268,ITM_269,Work Value,Apparel,396,140,537,193,550,358,58,569,153,498,319,632,4403,2,8806,270298534,25.207645633229657,25.207645633229657,236,Dec_Demand,Jul_Demand,574,10.89654984542244
269,ITM_270,Approach Involve,Grocery,1083,926,967,1356,1060,878,1173,1274,728,1209,1313,508,12475,10,124750,270423284,25.219279635627707,25.219279635627707,-575,Apr_Demand,Dec_Demand,848,2.669291286037573
270,ITM_271,Tend Hand,Grocery,2295,2404,2555,2592,2407,2094,2110,2384,2644,2476,2246,2614,28821,2,57642,270480926,25.224655244174627,25.224655244174627,319,Sep_Demand,Jun_Demand,550,1.262655199318743
271,ITM_272,Language Up,Apparel,876,982,680,712,953,759,975,550,936,804,696,830,9753,10,97530,270578456,25.233750749215766,25.233750749215766,-46,Feb_Demand,Aug_Demand,432,1.7854545129917363
272,ITM_273,Kind Thousand,Toys,343,272,305,303,306,323,324,334,321,377,295,307,3810,50,190500,270768956,25.25151650037271,25.25151650037271,-36,Oct_Demand,Feb_Demand,105,1.3860293608077443
273,ITM_274,Whose Debate,Grocery,2693,2095,2551,2427,2157,2451,2450,2523,2262,2567,2209,2090,28475,10,284750,271053706,25.278071868571864,25.278071868571864,-603,Jan_Demand,Dec_Demand,603,1.2885167402463313
274,ITM_275,Bank Parent,Home & Kitchen,59,66,74,78,66,76,75,86,64,84,70,72,870,10,8700,271062406,25.2788832178373,25.2788832178373,13,Aug_Demand,Jan_Demand,27,1.4576268715886658
275,ITM_276,Station Perhaps,Home & Kitchen,271,301,302,303,256,281,303,272,288,277,289,282,3425,10,34250,271096656,25.282077322704097,25.282077322704097,11,Apr_Demand,May_Demand,47,1.183593703765871
276,ITM_277,Such Fight,Home & Kitchen,362,367,314,363,389,343,340,381,360,362,404,339,4324,2,8648,271105304,25.282883822525648,25.282883822525648,-23,Nov_Demand,Mar_Demand,90,1.2866241628463644
277,ITM_278,Dog Begin,Toys,83,78,70,80,75,81,63,49,74,61,86,59,859,2,1718,271107022,25.28304404069094,25.28304404069094,-24,Nov_Demand,Aug_Demand,37,1.7551016826323096
278,ITM_279,Stay However,Grocery,1916,1698,1674,1620,1796,1618,1720,1415,1609,1616,1508,1692,19882,2,39764,271146786,25.286752373126657,25.286752373126657,-224,Jan_Demand,Aug_Demand,501,1.3540635946709287
279,ITM_280,According Off,Apparel,986,1247,1185,1119,707,883,837,689,813,903,1221,877,11467,500,5733500,276880286,25.821450190755673,25.821450190755673,-109,Feb_Demand,Aug_Demand,558,1.8098693496390517
280,ITM_281,Hard Money,Apparel,758,477,694,745,728,272,451,473,528,329,572,438,6465,2,12930,276893216,25.822656023629474,25.822656023629474,-320,Jan_Demand,Jun_Demand,486,2.786764603427772
281,ITM_282,Final On,Apparel,418,347,454,55,361,130,26,57,383,429,56,256,2972,50,148600,277041816,25.836514242117254,25.836514242117254,-162,Mar_Demand,Jul_Demand,428,17.461531745564713
282,ITM_283,List Data,Apparel,1224,763,1109,939,1033,734,1208,968,1095,954,721,742,11490,10,114900,277156716,25.847229647933172,25.847229647933172,-482,Jan_Demand,Nov_Demand,503,1.6976421401159205
283,ITM_284,Lot By,Toys,163,144,163,154,160,154,165,165,159,163,156,164,1910,2,3820,277160536,25.847585895541673,25.847585895541673,1,Jul_Demand,Feb_Demand,21,1.1458332537615796
284,ITM_285,Account Spring,Grocery,4763,4972,4664,4657,4784,5156,4913,4545,4662,5010,4920,4768,57814,10,578140,277738676,25.901502385693245,25.901502385693245,5,Jun_Demand,Aug_Demand,611,1.1344334408483314
285,ITM_286,Owner Economy,Grocery,2288,1607,1501,2156,1983,1887,2014,1941,1730,1667,1906,2340,23020,2,46040,277784716,25.905796008702513,25.905796008702513,52,Dec_Demand,Mar_Demand,839,1.558960682485272
286,ITM_287,Certain Heart,Electronics,114,115,123,87,105,103,116,111,121,120,105,119,1339,10,13390,277798106,25.907044740502993,25.907044740502993,5,Mar_Demand,Apr_Demand,36,1.41379294094334
287,ITM_288,Learn Keep,Apparel,983,1081,927,752,1170,654,739,1153,653,744,1163,666,10685,50,534250,278332356,25.95686811349825,25.95686811349825,-317,May_Demand,Sep_Demand,517,1.7917304472935613
288,ITM_289,Similar Become,Apparel,231,233,323,484,302,251,215,37,101,126,255,61,2619,500,1309500,279641856,26.07899016672668,26.07899016672668,-170,Apr_Demand,Aug_Demand,447,13.081077545654717
289,ITM_290,Method Form,Electronics,251,266,243,277,268,260,259,250,276,255,257,235,3097,50,154850,279796706,26.09343125106606,26.09343125106606,-16,Apr_Demand,Dec_Demand,42,1.1787233540968785
290,ITM_291,Offer Individual,Grocery,1821,1804,1920,1581,1653,1407,1336,1465,1408,1564,1939,2088,19986,50,999300,280796006,26.186624506347595,26.186624506347595,267,Dec_Demand,Jul_Demand,752,1.5628742397988455
291,ITM_292,Politics Late,Home & Kitchen,304,328,321,328,329,336,337,329,313,299,337,336,3897,2,7794,280803800,26.187351363379182,26.187351363379182,32,Jul_Demand,Oct_Demand,38,1.127090263308018
292,ITM_293,White Music,Grocery,4268,4188,4391,3998,4785,3749,4369,4235,4032,3738,4372,4108,50233,10,502330,281306130,26.234197923897117,26.234197923897117,-160,May_Demand,Oct_Demand,1047,1.2800963047616472
293,ITM_294,But Run,Grocery,1814,1758,1459,1622,1419,1602,1389,1443,2227,1821,1749,1588,19891,2,39782,281345912,26.23790793498649,26.23790793498649,-226,Sep_Demand,Jul_Demand,838,1.6033117235182741
294,ITM_295,What Nearly,Toys,110,105,97,106,103,105,121,101,98,100,89,96,1231,10,12310,281358222,26.239055947567813,26.239055947567813,-14,Jul_Demand,Nov_Demand,32,1.3595504090392798
295,ITM_296,Everything Drug,Apparel,336,348,293,233,498,436,511,371,467,268,20,487,4268,2,8536,281366758,26.239852002433302,26.239852002433302,151,Jul_Demand,Nov_Demand,491,25.549987225006387
296,ITM_297,Drive Analysis,Grocery,4612,4706,4272,4385,4414,4455,4644,4669,4548,4435,4495,4572,54207,2,108414,281475172,26.24996253338306,26.24996253338306,-40,Feb_Demand,Mar_Demand,434,1.101591757720993
297,ITM_298,Free Hard,Grocery,2958,3196,3009,3437,3174,3076,3453,3220,3334,3454,3220,3566,39097,100,3909700,285384872,26.614575432586715,26.614575432586715,608,Dec_Demand,Jan_Demand,608,1.2055442826046507
298,ITM_299,Hit Affect,Grocery,1865,2075,1752,2179,2186,2440,2253,1829,1925,1847,1905,2272,24528,10,245280,285630152,26.63744988635981,26.63744988635981,407,Jun_Demand,Mar_Demand,688,1.3926940559777736
299,ITM_300,Expect Into,Electronics,512,451,455,467,479,455,524,471,471,466,477,447,5675,2,11350,285641502,26.638508370746326,26.638508370746326,-65,Jul_Demand,Dec_Demand,77,1.1722594816049334
300,ITM_301,Move Single,Electronics,311,331,365,356,336,337,329,300,304,338,321,356,3984,2,7968,285649470,26.639251454763222,26.639251454763222,45,Mar_Demand,Aug_Demand,65,1.2166666261111125
301,ITM_302,Southern Away,Grocery,2632,2926,2619,2677,2806,2461,2559,2549,2863,2369,2649,2713,31823,500,15911500,301560970,28.123134654415107,28.123134654415107,81,Feb_Demand,Oct_Demand,557,1.235120298712029
302,ITM_303,Phone Participant,Home & Kitchen,362,352,355,336,378,372,358,375,395,397,348,337,4365,10,43650,301604620,28.12720538952272,28.12720538952272,-25,Oct_Demand,Apr_Demand,61,1.1815475838825125
303,ITM_304,Traditional Camera,Electronics,179,168,165,171,190,165,177,146,149,178,182,158,2028,1000,2028000,303632620,28.316333701051743,28.316333701051743,-21,May_Demand,Aug_Demand,44,1.3013697738787826
304,ITM_305,Listen City,Electronics,400,411,449,426,415,396,451,402,401,368,378,411,4908,10,49080,303681700,28.320910830011233,28.320910830011233,11,Jul_Demand,Oct_Demand,83,1.2255434449580587
305,ITM_306,Several Treat,Electronics,479,457,466,448,524,494,514,475,467,475,475,499,5773,10,57730,303739430,28.326294645309343,28.326294645309343,20,May_Demand,Apr_Demand,76,1.1696428310347584
306,ITM_307,Response Despite,Electronics,359,352,377,372,372,372,360,412,389,392,385,359,4501,50,225050,303964480,28.347282478893963,28.347282478893963,0,Aug_Demand,Feb_Demand,60,1.1704545122029968
307,ITM_308,School Leg,Grocery,1519,2133,1760,2017,1825,1764,1517,1946,1534,1799,1772,2050,21636,2,43272,304007752,28.35131796227487,28.35131796227487,531,Feb_Demand,Jul_Demand,616,1.406064591917834
308,ITM_309,Poor Her,Grocery,4760,4681,5224,4789,4436,4922,5136,4646,4584,4969,4685,4674,57506,10,575060,304582812,28.404947216134772,28.404947216134772,-86,Mar_Demand,May_Demand,788,1.1776375086166875
309,ITM_310,Apply Question,Apparel,1055,662,882,834,639,1055,639,1017,1012,967,929,698,10389,10,103890,304686702,28.414635845466503,28.414635845466503,-357,Jan_Demand,May_Demand,416,1.6510171885599814
310,ITM_311,Out Serve,Electronics,342,344,328,302,322,333,316,298,323,309,346,329,3892,2,7784,304694486,28.415361769912725,28.415361769912725,-13,Nov_Demand,Aug_Demand,48,1.1610737865411482
311,ITM_312,Wrong Week,Apparel,349,119,177,65,128,427,157,95,179,316,387,309,2708,2,5416,304699902,28.415866858145094,28.415866858145094,-40,Jun_Demand,Apr_Demand,362,6.569229758580037
312,ITM_313,System Pick,Apparel,467,899,650,373,426,956,468,876,554,962,511,693,7835,2,15670,304715572,28.41732821940824,28.41732821940824,226,Oct_Demand,Apr_Demand,589,2.579088402705405
313,ITM_314,Unit It,Grocery,3960,4376,4281,4337,4153,4460,4177,3716,4376,4203,3732,3835,49606,100,4960600,309676172,28.879946514364285,28.879946514364285,-125,Jun_Demand,Aug_Demand,744,1.200215282023102
314,ITM_315,The Commercial,Electronics,192,193,196,195,189,182,185,212,187,218,199,193,2341,10,23410,309699582,28.882129696698062,28.882129696698062,1,Oct_Demand,Jun_Demand,36,1.1978021319888938
315,ITM_316,Laugh Likely,Apparel,947,1001,1022,959,862,906,688,523,632,1065,789,568,9962,50,498100,310197682,28.92858177360763,28.92858177360763,-379,Oct_Demand,Aug_Demand,542,2.0363288329573836
316,ITM_317,Address Woman,Toys,74,71,67,61,64,67,71,55,73,74,67,71,815,100,81500,310279182,28.936182344312567,28.936182344312567,-3,Jan_Demand,Aug_Demand,19,1.3454543008264908
317,ITM_318,Road Poor,Home & Kitchen,61,57,55,55,61,67,63,69,74,63,74,62,761,2,1522,310280704,28.93632428380475,28.93632428380475,1,Sep_Demand,Mar_Demand,19,1.3454543008264908
318,ITM_319,Method Responsibility,Grocery,2231,1822,2034,1624,2264,2070,1853,1955,2551,2204,2228,2242,25078,2,50156,310330860,28.941001758949252,28.941001758949252,11,Sep_Demand,Apr_Demand,927,1.5708127982092808
319,ITM_320,Husband Knowledge,Grocery,4476,4473,4739,4396,4714,4684,4103,4685,4202,4292,4710,4267,53741,2,107482,310438342,28.951025372943217,28.951025372943217,-209,Mar_Demand,Jul_Demand,636,1.1550085275286168
320,ITM_321,Movement Left,Grocery,1655,1130,1267,1528,1624,1241,1114,1450,1347,1369,1357,1477,16559,2,33118,310471460,28.954113909146976,28.954113909146976,-178,Jan_Demand,Jul_Demand,541,1.485637329572376
321,ITM_322,Father Understand,Grocery,2491,1635,1626,2050,1550,1777,1906,1905,1825,1702,2236,1889,22592,2,45184,310516644,28.958327702849207,28.958327702849207,-602,Jan_Demand,May_Demand,941,1.6070967638251823
322,ITM_323,Give Cut,Grocery,4131,4217,4408,5003,4471,4496,4079,4289,4338,4681,4277,4420,52810,10,528100,311044744,29.007577535846483,29.007577535846483,289,Apr_Demand,Jul_Demand,924,1.2265261063335962
323,ITM_324,Congress Artist,Grocery,1131,1296,1374,1328,1231,1373,1092,864,1151,833,1169,1065,13907,2,27814,311072558,29.010171428773933,29.010171428773933,-66,Mar_Demand,Oct_Demand,541,1.6494597641121278
324,ITM_325,Plan Field,Electronics,94,90,115,95,112,90,90,90,88,98,86,102,1150,2,2300,311074858,29.010385923407323,29.010385923407323,8,Mar_Demand,Nov_Demand,29,1.3372091468361456
325,ITM_326,Eat Stay,Electronics,194,206,201,187,181,185,196,177,186,153,181,173,2220,100,222000,311296858,29.03108931845636,29.03108931845636,-21,Feb_Demand,Oct_Demand,53,1.346405140757834
326,ITM_327,Run Nature,Electronics,104,105,122,90,109,101,119,93,112,102,100,113,1270,2,2540,311299398,29.03132619513845,29.03132619513845,9,Mar_Demand,Apr_Demand,32,1.3555554049382883
327,ITM_328,Claim Moment,Apparel,709,728,1176,804,1257,1281,946,1156,1266,1230,1080,864,12497,2,24994,311324392,29.033657098993658,29.033657098993658,155,Jun_Demand,Jan_Demand,572,1.8067700732472487
328,ITM_329,Be Help,Grocery,1704,1876,1143,1723,1539,1620,1501,1465,1507,1543,1294,1640,18555,2,37110,311361502,29.03711792327415,29.03711792327415,-64,Feb_Demand,Mar_Demand,733,1.641294823785697
329,ITM_330,Wind Perhaps,Home & Kitchen,429,463,476,474,450,478,428,447,478,465,467,448,5503,10,55030,311416532,29.042249940524368,29.042249940524368,19,Jun_Demand,Jul_Demand,50,1.1168224038125607
330,ITM_331,Why Owner,Electronics,250,275,297,279,285,308,280,293,260,282,289,272,3370,10,33700,311450232,29.045392753196225,29.045392753196225,22,Jun_Demand,Jan_Demand,58,1.231999950720002
331,ITM_332,Generation Outside,Apparel,1130,789,1156,907,765,1005,1163,811,1085,1073,1054,769,11707,500,5853500,317303732,29.59128159517607,29.59128159517607,-361,Jul_Demand,May_Demand,398,1.5202614180357985
332,ITM_333,Others He,Apparel,24,315,24,269,45,200,270,24,170,502,56,532,2431,50,121550,317425282,29.6026171702581,29.6026171702581,508,Dec_Demand,Jan_Demand,508,22.166657430559404
333,ITM_334,Head Clear,Grocery,2710,2754,2974,2766,2594,2490,2754,2789,2574,2995,2705,2738,32843,2,65686,317490968,29.60874295047067,29.60874295047067,28,Oct_Demand,Jun_Demand,505,1.2028112401493523
334,ITM_335,Describe That,Toys,205,176,174,205,172,165,178,201,182,187,182,175,2202,10,22020,317512988,29.610796503439047,29.610796503439047,-30,Jan_Demand,Jun_Demand,40,1.242424167125808
335,ITM_336,Month Theory,Apparel,645,774,364,398,374,438,707,580,477,277,646,337,6017,2,12034,317525022,29.611918776664364,29.611918776664364,-308,Feb_Demand,Oct_Demand,497,2.794223725840299
336,ITM_337,Work Explain,Electronics,254,287,236,260,239,236,250,233,264,238,258,263,3018,500,1509000,319034022,29.752645907876047,29.752645907876047,9,Feb_Demand,Aug_Demand,54,1.2317596037871414
337,ITM_338,Low Either,Electronics,238,241,226,232,249,233,231,216,239,234,226,234,2799,50,139950,319173972,29.765697440025203,29.765697440025203,-4,May_Demand,Aug_Demand,33,1.1527777244084387
338,ITM_339,Message Exactly,Electronics,501,461,513,457,450,443,454,474,486,453,426,433,5551,100,555100,319729072,29.817465253501414,29.817465253501414,-68,Mar_Demand,Nov_Demand,87,1.204225323844476
339,ITM_340,Customer Yet,Grocery,4430,4570,5260,4866,5027,4904,5076,5219,4888,5189,5080,5061,59570,2,119140,319848212,29.828576075511062,29.828576075511062,631,Mar_Demand,Jan_Demand,830,1.187358913798287
340,ITM_341,Memory Live,Apparel,413,395,175,376,331,263,459,9,10,516,77,520,3544,50,177200,320025412,29.84510148813579,29.84510148813579,107,Dec_Demand,Aug_Demand,511,57.77771358031825
341,ITM_342,Type Save,Grocery,1713,1450,1684,1756,1340,1185,1831,1407,1566,1633,1531,1850,18946,2,37892,320063304,29.848635240591637,29.848635240591637,137,Dec_Demand,Jun_Demand,665,1.5611814214246293
342,ITM_343,Discussion Class,Apparel,528,717,675,564,968,969,1029,772,753,730,1048,729,9482,2,18964,320082268,29.850403795473213,29.850403795473213,201,Nov_Demand,Jan_Demand,520,1.9848484472566583
343,ITM_344,Trouble Sure,Grocery,4033,3927,4649,4137,4310,4658,4704,3982,4086,4116,4253,4360,51215,100,5121500,325203768,30.328027388912997,30.328027388912997,327,Jul_Demand,Feb_Demand,777,1.1978609595165242
344,ITM_345,Most Role,Grocery,2279,2472,2209,2101,2075,2050,2109,2225,2400,2273,2209,2250,26652,2,53304,325257072,30.332998441929636,30.332998441929636,-29,Feb_Demand,Jun_Demand,422,1.2058536526543724
345,ITM_346,Raise Use,Grocery,4044,4208,4330,4401,4185,4041,4361,3835,4570,4243,4311,4444,50973,10,509730,325766802,30.38053511561587,30.38053511561587,400,Sep_Demand,Aug_Demand,735,1.191655798717977
346,ITM_347,Present Training,Apparel,859,672,1179,1138,1195,753,749,943,815,1201,840,1146,11490,50,574500,326341302,30.43411214469547,30.43411214469547,287,Oct_Demand,Feb_Demand,529,1.7872023543571078
347,ITM_348,Without Sort,Grocery,2340,2002,2112,2282,1938,1899,2271,1808,2188,1973,2250,2415,25478,10,254780,326596082,30.457872554563004,30.457872554563004,75,Dec_Demand,Aug_Demand,607,1.3357300811076875
348,ITM_349,Tv Central,Electronics,431,414,454,434,434,464,422,462,435,403,434,442,5229,2,10458,326606540,30.45884785233518,30.45884785233518,11,Jun_Demand,Oct_Demand,61,1.1513647356981456
349,ITM_350,Pretty Level,Electronics,395,381,406,416,452,354,428,380,423,393,393,368,4789,2,9578,326616118,30.45974108259545,30.45974108259545,-27,May_Demand,Jun_Demand,98,1.2768361221232736
350,ITM_351,Song Yard,Toys,41,49,49,63,44,54,50,58,56,45,48,50,607,10,6070,326622188,30.460307161910528,30.460307161910528,9,Apr_Demand,Jan_Demand,22,1.5365849910768312
351,ITM_352,Occur Help,Toys,215,219,227,239,221,202,197,199,230,212,198,215,2574,10,25740,326647928,30.46270763663378,30.46270763663378,0,Apr_Demand,Jul_Demand,42,1.213197907959497
352,ITM_353,With Behavior,Grocery,2161,1545,1937,1644,1799,1819,1954,1916,1913,1923,1934,1816,22361,1000,22361000,349008928,32.54806176587463,32.54806176587463,-345,Jan_Demand,Feb_Demand,616,1.398705492565013
353,ITM_354,War Can,Electronics,68,87,81,91,60,81,93,67,82,66,80,78,934,10,9340,349018268,32.54893280060327,32.54893280060327,10,Jul_Demand,May_Demand,33,1.5499997416667097
354,ITM_355,Respond Without,Electronics,398,417,392,386,424,391,397,368,394,406,379,426,4778,2,9556,349027824,32.54982397917574,32.54982397917574,28,Dec_Demand,Aug_Demand,58,1.1576086641954169
355,ITM_356,Take House,Grocery,1745,1699,1857,1941,1809,2003,1429,1891,1384,1515,1536,1669,20478,500,10239000,359266824,33.50469813191028,33.50469813191028,-76,Jun_Demand,Sep_Demand,619,1.4472543248030758
356,ITM_357,Along Test,Grocery,3449,3816,3635,3629,3352,3656,3615,3323,3354,3765,3498,3602,42694,10,426940,359693764,33.54451393137981,33.54451393137981,153,Feb_Demand,Aug_Demand,493,1.1483599122829975
357,ITM_358,Win Expert,Apparel,549,1037,1050,930,1090,678,813,777,969,593,662,825,9973,50,498650,360192414,33.59101730048432,33.59101730048432,276,May_Demand,Jan_Demand,541,1.9854280148373769
358,ITM_359,Size Could,Home & Kitchen,126,124,135,120,125,121,112,126,135,137,128,107,1496,10,14960,360207374,33.59241244818672,33.59241244818672,-19,Oct_Demand,Dec_Demand,30,1.2803737121146064
359,ITM_360,Service Focus,Apparel,530,686,158,630,203,609,149,286,464,337,123,410,4585,2,9170,360216544,33.5932676289642,33.5932676289642,-120,Feb_Demand,Nov_Demand,563,5.577235318923957
360,ITM_361,Serve Ready,Grocery,4715,4847,4634,4806,5023,4655,5000,5001,4872,4692,5255,5126,58626,100,5862600,366079144,34.14000512362398,34.14000512362398,411,Nov_Demand,Mar_Demand,621,1.134009492589535
361,ITM_362,Bill Know,Toys,334,291,317,316,317,324,314,293,314,316,304,291,3731,2,7462,366086606,34.14070101882153,34.14070101882153,-43,Jan_Demand,Feb_Demand,43,1.1477662835819147
362,ITM_363,On Involve,Grocery,1394,1265,1557,1164,1307,1118,968,1367,853,1318,1335,1013,14659,10,146590,366233196,34.154371787651435,34.154371787651435,-381,Mar_Demand,Sep_Demand,704,1.8253223701603474
363,ITM_364,Mrs Expect,Toys,188,179,156,178,174,210,169,181,181,188,186,160,2150,10,21500,366254696,34.156376846180954,34.156376846180954,-28,Jun_Demand,Mar_Demand,54,1.3461537598619384
364,ITM_365,Total Occur,Home & Kitchen,282,327,299,298,298,345,333,324,320,315,309,314,3764,1000,3764000,370018696,34.50740197665198,34.50740197665198,32,Jun_Demand,Jan_Demand,63,1.223404211936021
365,ITM_366,Vote Lawyer,Electronics,94,101,83,85,84,92,102,90,88,88,84,76,1067,2,2134,370020830,34.50760099036835,34.50760099036835,-18,Jul_Demand,Dec_Demand,26,1.34210508656512
366,ITM_367,Anyone Maybe,Grocery,1665,1524,1819,1739,1554,1515,1644,1497,1330,1432,1252,1696,18667,10,186670,370207500,34.52500956133143,34.52500956133143,31,Mar_Demand,Nov_Demand,567,1.4528753877565863
367,ITM_368,Compare Husband,Electronics,337,307,325,329,335,336,303,294,317,311,276,300,3770,10,37700,370245200,34.52852540814832,34.52852540814832,-37,Jan_Demand,Nov_Demand,61,1.2210144485139693
368,ITM_369,Head Agreement,Home & Kitchen,221,213,197,245,240,213,223,235,214,213,220,222,2656,2,5312,370250512,34.52902079749291,34.52902079749291,1,Apr_Demand,Mar_Demand,48,1.2436547592053422
369,ITM_370,Form Goal,Home & Kitchen,218,252,222,235,221,232,239,266,215,229,229,191,2749,50,137450,370387962,34.54183918330143,34.54183918330143,-27,Aug_Demand,Dec_Demand,75,1.3926700841533988
370,ITM_371,Hit Phone,Electronics,445,456,430,444,412,444,466,477,465,455,445,414,5353,2,10706,370398668,34.54283760919059,34.54283760919059,-31,Aug_Demand,May_Demand,65,1.1577669621901223
371,ITM_372,Decade Win,Apparel,380,620,540,381,478,369,535,217,338,643,163,114,4778,50,238900,370637568,34.56511707350237,34.56511707350237,-266,Oct_Demand,Dec_Demand,529,5.640350382425405
372,ITM_373,Hundred Movement,Toys,351,321,362,342,356,336,377,372,331,320,344,358,4170,10,41700,370679268,34.56900595446428,34.56900595446428,7,Jul_Demand,Oct_Demand,57,1.178124963183595
373,ITM_374,Nearly Start,Grocery,3532,4116,4253,3847,3812,3542,4242,3604,4038,3883,3845,3779,46493,10,464930,371144198,34.61236464572621,34.61236464572621,247,Mar_Demand,Jan_Demand,721,1.2041336319248763
374,ITM_375,Race Food,Grocery,2095,2310,2738,2216,2221,2144,1822,1910,2147,2460,1764,1841,25668,100,2566800,373710998,34.85174065659046,34.85174065659046,-254,Mar_Demand,Nov_Demand,974,1.5521541862122779
375,ITM_376,Increase Box,Electronics,321,314,324,335,316,330,332,301,315,347,351,327,3913,2,7826,373718824,34.852470497895204,34.852470497895204,6,Nov_Demand,Aug_Demand,50,1.1661129180693384
376,ITM_377,Against Certainly,Toys,342,306,298,309,347,283,308,340,329,331,292,313,3798,2,7596,373726420,34.85317888973661,34.85317888973661,-29,May_Demand,Jun_Demand,64,1.2261483665671957
377,ITM_378,There Wind,Grocery,2126,1468,1777,1668,1885,1772,1941,1499,1707,1693,1605,1588,20729,100,2072900,375799320,35.046494509543564,35.046494509543564,-538,Jan_Demand,Feb_Demand,658,1.4482288729684683
378,ITM_379,Bed Describe,Apparel,257,502,360,121,22,106,50,32,543,85,59,214,2351,2,4702,375804022,35.046933011181046,35.046933011181046,-43,Sep_Demand,May_Demand,521,24.681806962815017
379,ITM_380,Director Them,Home & Kitchen,138,133,140,126,137,144,139,132,134,137,112,123,1595,2,3190,375807212,35.047230505911706,35.047230505911706,-15,Jun_Demand,Nov_Demand,32,1.2857141709183775
380,ITM_381,Sign Risk,Grocery,4349,4623,4436,4204,4190,4598,4164,4779,4327,4264,4242,4193,52369,100,5236900,381044112,35.535616134435536,35.535616134435536,-156,Aug_Demand,Jul_Demand,615,1.1476945217394465
381,ITM_382,Phone Pretty,Apparel,393,7,8,8,503,527,59,207,148,302,311,12,2485,2,4970,381049082,35.536079629360735,35.536079629360735,-381,Jun_Demand,Feb_Demand,520,75.28560673484752
382,ITM_383,Parent Current,Electronics,72,100,83,82,76,84,84,93,86,74,96,81,1011,10,10110,381059192,35.53702247316229,35.53702247316229,9,Feb_Demand,Jan_Demand,28,1.388888695987681
383,ITM_384,Character Sing,Grocery,4581,4430,4863,4836,4458,4690,4528,4464,4742,4600,4869,4591,55652,10,556520,381615712,35.58892271375999,35.58892271375999,10,Nov_Demand,Feb_Demand,439,1.0990970629817223
384,ITM_385,Television Certainly,Toys,211,215,242,209,205,211,180,224,205,221,218,219,2560,50,128000,381743712,35.60085980640088,35.60085980640088,8,Mar_Demand,Jul_Demand,62,1.3444443697530906
385,ITM_386,Pressure Tree,Grocery,4387,3876,4119,4626,4411,4319,4800,4409,4295,4489,4219,4660,52610,100,5261000,387004712,36.0914929656485,36.0914929656485,273,Jul_Demand,Feb_Demand,924,1.2383900896842361
386,ITM_387,Check Consider,Grocery,1456,1368,1112,1284,1354,913,1151,1083,1208,1207,1498,1129,14763,2,29526,387034238,36.09424651719002,36.09424651719002,-327,Nov_Demand,Jun_Demand,585,1.6407447794003858
387,ITM_388,Your Different,Electronics,367,362,377,386,329,345,352,323,387,404,381,370,4383,2,8766,387043004,36.095064021518844,36.095064021518844,3,Oct_Demand,Aug_Demand,81,1.2507739550843977
388,ITM_389,Game Special,Electronics,334,283,305,316,315,331,319,306,300,321,327,324,3781,50,189050,387232054,36.11269454779822,36.11269454779822,-10,Jan_Demand,Feb_Demand,51,1.1802119724306726
389,ITM_390,Peace On,Electronics,277,265,323,291,261,292,299,287,289,327,314,291,3516,50,175800,387407854,36.12908939847218,36.12908939847218,14,Oct_Demand,May_Demand,66,1.2528735152155743
390,ITM_391,Laugh Heavy,Apparel,173,402,261,167,178,573,205,270,379,414,605,369,3996,2,7992,387415846,36.12983472069395,36.12983472069395,196,Nov_Demand,Apr_Demand,438,3.6227542740865704
391,ITM_392,Happy Prevent,Electronics,146,169,149,137,134,138,139,141,130,151,169,159,1762,10,17620,387433466,36.1314779361028,36.1314779361028,13,Feb_Demand,Sep_Demand,39,1.2999999000000078
392,ITM_393,Get Story,Apparel,275,758,553,225,531,708,727,385,438,803,742,675,6820,50,341000,387774466,36.163279096966406,36.163279096966406,400,Oct_Demand,Apr_Demand,578,3.568888730271612
393,ITM_394,Than Car,Grocery,1289,1664,1643,1589,1662,1642,1655,1850,1446,1683,1885,1517,19525,50,976250,388750716,36.25432274298721,36.25432274298721,228,Nov_Demand,Jan_Demand,596,1.4623739219365872
394,ITM_395,Animal Key,Grocery,5180,4626,5010,4802,4856,5361,5504,4910,4631,4959,4867,4903,59609,500,29804500,418555216,39.0338467868564,39.0338467868564,-277,Jul_Demand,Feb_Demand,878,1.1897967981197648
395,ITM_396,Thing Teach,Electronics,458,443,423,406,417,398,481,425,427,413,413,409,5113,50,255650,418810866,39.05768833165048,39.05768833165048,-49,Jul_Demand,Jun_Demand,83,1.2085426832024453
396,ITM_397,Analysis Oil,Electronics,71,64,74,53,66,69,58,69,67,69,62,61,783,10,7830,418818696,39.058418545989376,39.058418545989376,-10,Mar_Demand,Apr_Demand,21,1.396226151655443
397,ITM_398,Edge Understand,Apparel,154,266,56,488,224,87,6,213,309,368,451,12,2634,50,131700,418950396,39.07070069521441,39.07070069521441,-142,Apr_Demand,Jul_Demand,482,81.33319777800371
398,ITM_399,Court Product,Toys,322,350,299,322,330,288,309,342,337,292,328,315,3834,2,7668,418958064,39.071415801670426,39.071415801670426,-7,Feb_Demand,Jun_Demand,62,1.2152777355806343
399,ITM_400,We Challenge,Grocery,3397,3792,3147,3506,3228,3406,3324,3234,3396,3256,3652,3467,40805,2,81610,419039674,39.079026630814354,39.079026630814354,70,Feb_Demand,Mar_Demand,645,1.2049570981729993
400,ITM_401,Morning Indeed,Electronics,478,501,493,472,468,485,461,499,475,494,487,517,5830,50,291500,419331174,39.10621149413325,39.10621149413325,39,Dec_Demand,Jul_Demand,56,1.121475029902928
401,ITM_402,Consider Water,Electronics,83,81,77,77,67,87,96,80,79,73,76,88,964,10,9640,419340814,39.107110506422764,39.107110506422764,5,Jul_Demand,May_Demand,29,1.4328356070394617
402,ITM_403,Form Know,Grocery,2862,2574,2136,2836,2416,2963,2538,2695,2911,2562,2124,2805,31422,50,1571100,420911914,39.253628992736,39.253628992736,-57,Jun_Demand,Nov_Demand,839,1.395009409628016
403,ITM_404,Suggest Seem,Grocery,2491,2572,2625,2756,2771,2527,2547,2460,2306,2681,2328,2730,30794,10,307940,421219854,39.28234702639095,39.28234702639095,239,May_Demand,Sep_Demand,465,1.2016478698974506
404,ITM_405,Particularly Improve,Apparel,1012,1042,623,636,1092,901,748,1088,951,1103,1078,954,11228,2,22456,421242310,39.28444124008114,39.28444124008114,-58,Oct_Demand,Mar_Demand,480,1.7704654611482271
405,ITM_406,Bank Turn,Electronics,131,158,118,163,148,141,126,132,152,126,138,131,1664,10,16640,421258950,39.285993062124454,39.285993062124454,0,Apr_Demand,Mar_Demand,45,1.3813558151393377
406,ITM_407,Remain Stock,Home & Kitchen,306,288,333,327,292,305,297,333,309,295,300,301,3686,10,36860,421295810,39.289430571770886,39.289430571770886,-5,Mar_Demand,Feb_Demand,45,1.156249959852432
407,ITM_408,Health Middle,Electronics,180,199,175,209,182,221,195,209,191,199,212,195,2367,10,23670,421319480,39.29163800132409,39.29163800132409,15,Jun_Demand,Mar_Demand,46,1.2628570706938818
408,ITM_409,Indicate Organization,Home & Kitchen,53,53,70,62,55,54,58,69,62,48,54,60,698,2,1396,421320876,39.2917681902407,39.2917681902407,7,Mar_Demand,Oct_Demand,22,1.458333029513952
409,ITM_410,Environmental Across,Grocery,1486,1573,1708,1434,1495,1547,1432,1577,1648,1838,1853,1372,18963,10,189630,421510506,39.3094528064711,39.3094528064711,-114,Nov_Demand,Dec_Demand,481,1.3505830805351087
410,ITM_411,Treat Address,Electronics,218,232,204,245,206,217,244,214,228,237,217,224,2686,10,26860,421537366,39.31195773075496,39.31195773075496,6,Apr_Demand,Mar_Demand,41,1.2009803332852778
411,ITM_412,Beautiful Site,Grocery,3821,3699,3678,3810,3892,3824,3979,3807,3882,3667,3986,3750,45795,2,91590,421628956,39.32049928009073,39.32049928009073,-71,Nov_Demand,Oct_Demand,319,1.0869920886637794
412,ITM_413,Growth Someone,Grocery,1776,1547,1919,1664,1710,1732,1690,1500,1548,2079,1842,1544,20551,2,41102,421670058,39.324332392447964,39.324332392447964,-232,Oct_Demand,Aug_Demand,579,1.38599999076
413,ITM_414,Base Protect,Apparel,570,654,394,643,469,573,859,822,372,593,456,530,6935,10,69350,421739408,39.33079987193738,39.33079987193738,-40,Jul_Demand,Sep_Demand,487,2.309139722872588
414,ITM_415,Citizen Between,Grocery,3661,3890,3652,3743,4073,4225,3879,4187,3833,3949,3414,4029,46535,2,93070,421832478,39.33947944390681,39.33947944390681,368,Jun_Demand,Nov_Demand,811,1.2375512558946946
415,ITM_416,Use Popular,Grocery,3291,3236,3556,3299,3403,3321,3126,3413,3505,3614,3425,2909,40098,10,400980,422233458,39.37687425177511,39.37687425177511,-382,Oct_Demand,Dec_Demand,705,1.2423513192081426
416,ITM_417,Near Away,Home & Kitchen,79,83,61,85,100,87,76,92,79,80,72,86,980,50,49000,422282458,39.381443920051694,39.381443920051694,7,May_Demand,Mar_Demand,39,1.6393439935501648
417,ITM_418,Finally Turn,Toys,364,373,350,362,358,377,373,386,382,350,337,391,4403,1000,4403000,426685458,39.79206125519089,39.79206125519089,27,Dec_Demand,Nov_Demand,54,1.1602373542956275
418,ITM_419,Carry Music,Home & Kitchen,161,174,155,161,150,159,143,150,173,153,144,145,1868,50,93400,426778858,39.80077160247728,39.80077160247728,-16,Feb_Demand,Jul_Demand,31,1.2167831316934872
419,ITM_420,Reach Early,Electronics,236,272,233,252,241,231,249,236,262,260,227,229,2928,2,5856,426784714,39.801317724465605,39.801317724465605,-7,Feb_Demand,Nov_Demand,45,1.1982378326767475
420,ITM_421,Magazine Late,Electronics,116,107,115,95,99,115,121,108,112,108,102,91,1289,500,644500,427429214,39.861422851083184,39.861422851083184,-25,Jul_Demand,Dec_Demand,30,1.329670183552727
421,ITM_422,Great Again,Electronics,118,135,114,120,110,118,127,130,133,128,135,119,1487,2,2974,427432188,39.86170020197001,39.86170020197001,1,Feb_Demand,May_Demand,25,1.2272726157024894
422,ITM_423,Machine Sure,Electronics,395,384,368,399,364,372,405,375,387,374,398,383,4604,10,46040,427478228,39.86599382497928,39.86599382497928,-12,Jul_Demand,May_Demand,41,1.112637332070403
423,ITM_424,Hope Fact,Grocery,2702,2716,2787,2909,2570,2955,2677,2857,2874,2922,2791,2422,33182,2,66364,427544592,39.87218283447943,39.87218283447943,-280,Jun_Demand,Dec_Demand,533,1.2200660560690912
424,ITM_425,Whole Understand,Electronics,236,260,244,237,267,233,258,224,252,232,248,230,2921,2,5842,427550434,39.87272765084825,39.87272765084825,-6,May_Demand,Aug_Demand,43,1.1919642325015967
425,ITM_426,Ok One,Home & Kitchen,471,461,506,470,418,461,480,474,448,431,422,446,5488,10,54880,427605314,39.87784567931803,39.87784567931803,-25,Mar_Demand,May_Demand,88,1.2105262868295148
426,ITM_427,Field Wife,Toys,401,389,391,409,423,403,401,423,407,399,408,439,4893,2,9786,427615100,39.878758307353834,39.878758307353834,38,Dec_Demand,Feb_Demand,50,1.1285346753590058
427,ITM_428,Hot Return,Grocery,1785,1610,1597,1667,1886,1795,1588,2046,1413,1778,1166,1721,20052,50,1002600,428617700,39.97225931580502,39.97225931580502,-64,Aug_Demand,Nov_Demand,880,1.7547169660830448
428,ITM_429,Edge Former,Electronics,342,344,298,328,370,343,342,321,323,337,344,329,4021,2,8042,428625742,39.9730093009536,39.9730093009536,-13,May_Demand,Mar_Demand,72,1.2416106965902451
429,ITM_430,Thousand Party,Grocery,2996,3251,2881,3123,2765,2672,2752,2916,2481,2959,3098,3098,34992,10,349920,428975662,40.005642327960615,40.005642327960615,102,Feb_Demand,Sep_Demand,770,1.3103587210384573
430,ITM_431,Later Rise,Home & Kitchen,389,379,395,390,398,400,373,384,388,356,407,392,4651,2,9302,428984964,40.00650981886488,40.00650981886488,3,Nov_Demand,Oct_Demand,51,1.1432583948522923
431,ITM_432,According Offer,Apparel,384,199,597,489,259,461,177,501,184,358,263,412,4284,2,8568,428993532,40.007308858003526,40.007308858003526,28,Mar_Demand,Jul_Demand,420,3.3728811653739452
432,ITM_433,Reduce Recognize,Grocery,4457,4330,4470,4554,4218,4407,4622,4391,4634,4884,4773,4614,54354,10,543540,429537072,40.05799860280061,40.05799860280061,157,Oct_Demand,May_Demand,666,1.1578947340969779
433,ITM_434,Art Discussion,Grocery,3541,3714,3761,3596,3785,3545,3692,3575,4013,3366,3941,3727,44256,2,88512,429625584,40.066253102361784,40.066253102361784,186,Sep_Demand,Oct_Demand,647,1.1922162769096367
434,ITM_435,Look Young,Electronics,208,255,255,266,254,262,243,248,245,241,242,239,2958,2,5916,429631500,40.06680481986228,40.06680481986228,31,Apr_Demand,Jan_Demand,58,1.2788460923631686
435,ITM_436,Sense Yeah,Apparel,951,395,918,711,561,763,383,945,635,931,614,674,8481,50,424050,430055550,40.10635110216202,40.10635110216202,-277,Jan_Demand,Jul_Demand,568,2.4830286557955965
436,ITM_437,Company Maybe,Grocery,2428,2478,2227,2267,2117,2215,2154,2101,2409,2086,2132,2221,26835,100,2683500,432739050,40.35661038420745,40.35661038420745,-207,Feb_Demand,Oct_Demand,392,1.187919457392524
437,ITM_438,Well While,Electronics,312,261,256,278,278,291,271,255,271,265,273,283,3294,2,6588,432745638,40.35722477144431,40.35722477144431,-29,Jan_Demand,Aug_Demand,57,1.2235293637831621
438,ITM_439,Family Executive,Grocery,4045,4239,4596,3965,3871,4460,4146,4464,3883,4401,4458,3790,50318,2,100636,432846274,40.366609937499064,40.366609937499064,-255,Mar_Demand,Dec_Demand,806,1.2126649044520714
439,ITM_440,Strong For,Apparel,964,1073,958,1097,1062,776,768,677,1234,698,776,894,10977,500,5488500,438334774,40.878459413745134,40.878459413745134,-70,Sep_Demand,Aug_Demand,557,1.8227473881425793
440,ITM_441,State Probably,Electronics,368,358,369,346,369,394,406,363,404,392,351,371,4491,10,44910,438379684,40.882647654608434,40.882647654608434,3,Jul_Demand,Apr_Demand,60,1.173410370710683
441,ITM_442,Need On,Grocery,3112,3104,3219,3197,2887,2944,3165,3176,2970,3225,3022,3135,37156,2,74312,438453996,40.889577882954754,40.889577882954754,23,Oct_Demand,May_Demand,338,1.1170765461826235
442,ITM_443,Doctor His,Grocery,2278,1672,1781,2063,1259,1619,1408,1524,2063,1698,1672,2106,21143,50,1057150,439511146,40.988166144558754,40.988166144558754,-172,Jan_Demand,May_Demand,1019,1.8093725034998214
443,ITM_444,Book Suffer,Grocery,2416,2460,2315,2620,2534,2599,2550,2949,2478,1994,2206,2314,29435,2,58870,439570016,40.9936562745882,40.9936562745882,-102,Aug_Demand,Oct_Demand,955,1.478936803014359
444,ITM_445,Number Congress,Electronics,98,84,79,83,88,91,82,106,85,99,91,87,1073,2,2146,439572162,40.993856407407,40.993856407407,-11,Aug_Demand,Mar_Demand,27,1.3417719820541794
445,ITM_446,Modern Far,Grocery,1649,1833,1844,1402,1936,1524,1922,1861,1852,2045,2365,2111,22344,500,11172000,450744162,42.03574077446925,42.03574077446925,462,Nov_Demand,Apr_Demand,963,1.6868758795515273
446,ITM_447,Term Fall,Grocery,4545,4582,4612,4702,4582,4456,4368,4336,4554,4437,4558,4548,54280,50,2714000,453458162,42.28884444187051,42.28884444187051,3,Apr_Demand,Aug_Demand,366,1.0844095915949965
447,ITM_448,Perform Low,Toys,346,322,328,336,319,329,299,289,299,324,325,316,3832,2,7664,453465826,42.28955917529238,42.28955917529238,-30,Jan_Demand,Aug_Demand,57,1.1972317924833291
448,ITM_449,Relationship Ever,Electronics,451,435,453,465,444,472,472,441,479,444,507,451,5514,2,11028,453476854,42.290587630430224,42.290587630430224,0,Nov_Demand,Feb_Demand,72,1.1655172145858113
449,ITM_450,Management Name,Toys,94,86,100,86,106,92,83,94,95,80,80,101,1097,10,10970,453487824,42.29161067657296,42.29161067657296,7,May_Demand,Oct_Demand,26,1.3249998343750207
450,ITM_451,Pattern Air,Grocery,1896,1684,1716,1810,1670,1664,1809,1927,1674,1630,1947,1393,20820,10,208200,453696024,42.31102710382165,42.31102710382165,-503,Nov_Demand,Dec_Demand,554,1.39770278967909
451,ITM_452,Old Despite,Toys,118,106,91,110,103,98,108,103,121,106,119,110,1293,50,64650,453760674,42.31705626819066,42.31705626819066,-8,Sep_Demand,Mar_Demand,30,1.329670183552727
452,ITM_453,Machine Executive,Grocery,4792,4595,4575,4711,4717,4911,4719,4809,4552,4293,4607,4367,55648,50,2782400,456543074,42.5765388194719,42.5765388194719,-425,Jun_Demand,Oct_Demand,618,1.1439552733660487
453,ITM_454,Assume Whatever,Electronics,234,252,262,250,241,236,280,268,264,238,225,244,2994,50,149700,456692774,42.590499622349554,42.590499622349554,10,Jul_Demand,Nov_Demand,55,1.244444389135805
454,ITM_455,My Rock,Apparel,324,316,79,259,502,129,587,465,446,651,593,658,5009,50,250450,456943224,42.6138562227551,42.6138562227551,334,Dec_Demand,Mar_Demand,579,8.329112869732548
455,ITM_456,Discover Trade,Apparel,404,113,325,156,204,182,92,174,270,266,182,392,2760,10,27600,456970824,42.61643015835579,42.61643015835579,-12,Jan_Demand,Jul_Demand,312,4.391303870510448
456,ITM_457,Make Thus,Electronics,175,150,154,169,152,155,168,168,148,172,155,164,1930,1000,1930000,458900824,42.79641913333164,42.79641913333164,-11,Jan_Demand,Sep_Demand,27,1.1824323525383544
457,ITM_458,Respond Or,Grocery,4791,4985,4771,5005,4770,5168,4797,4921,4818,5016,4796,4840,58678,2,117356,459018180,42.8073635821126,42.8073635821126,49,Jun_Demand,May_Demand,398,1.0834381528649095
458,ITM_459,Herself Develop,Apparel,797,709,671,591,637,1120,719,540,799,869,862,701,9015,50,450750,459468930,42.849399867330405,42.849399867330405,-96,Jun_Demand,Aug_Demand,580,2.0740740356652956
459,ITM_460,Certainly Build,Apparel,782,831,705,433,527,443,246,623,548,685,400,447,6670,10,66700,459535630,42.85562021169874,42.85562021169874,-335,Feb_Demand,Jul_Demand,585,3.3780486431687544
460,ITM_461,Trial Politics,Toys,341,299,315,313,305,298,332,332,309,312,291,302,3749,10,37490,459573120,42.859116474223015,42.859116474223015,-39,Jan_Demand,Nov_Demand,50,1.1718212655731526
461,ITM_462,Agency Rest,Apparel,456,309,14,119,343,192,211,368,316,113,536,96,3073,50,153650,459726770,42.87344564831889,42.87344564831889,-360,Nov_Demand,Mar_Demand,522,38.285686938795045
462,ITM_463,Issue Force,Grocery,4529,4800,4521,4801,4289,4419,4731,4289,4427,4118,4584,4512,54020,2,108040,459834810,42.883521300576085,42.883521300576085,-17,Apr_Demand,Oct_Demand,683,1.1658572094078261
463,ITM_464,None Break,Toys,316,286,300,284,292,319,316,283,316,294,279,298,3583,2,7166,459841976,42.8841895912469,42.8841895912469,-18,Jun_Demand,Nov_Demand,40,1.1433691346462678
464,ITM_465,Ever Own,Apparel,591,665,628,552,177,463,598,644,302,207,651,328,5806,2,11612,459853588,42.88527250936992,42.88527250936992,-263,Feb_Demand,May_Demand,488,3.7570619346292693
465,ITM_466,Behind Of,Grocery,1374,1586,973,1684,1215,1260,1282,1214,1373,1256,1246,1418,15881,2,31762,459885350,42.88823458699851,42.88823458699851,44,Apr_Demand,Mar_Demand,711,1.7307296841651625
466,ITM_467,Check Rather,Grocery,3191,3158,2902,3447,2954,3281,3394,3350,3351,2825,2831,3371,38055,50,1902750,461788100,43.06568226686135,43.06568226686135,180,Apr_Demand,Oct_Demand,622,1.2201769868312318
467,ITM_468,Physical Threat,Home & Kitchen,482,506,480,517,484,496,496,492,499,515,544,537,6048,10,60480,461848580,43.07132254313417,43.07132254313417,55,Nov_Demand,Mar_Demand,64,1.1333333097222227
468,ITM_469,And System,Grocery,4810,4610,4849,4755,5078,4627,4714,4701,4565,4687,4750,4792,56938,50,2846900,464695480,43.336820270003976,43.336820270003976,-18,May_Demand,Sep_Demand,513,1.1123767774099085
469,ITM_470,Whom Available,Grocery,2704,2617,2759,2979,2851,3052,2565,2572,2923,2593,2552,2617,32784,2,65568,464761048,43.342935045709275,43.342935045709275,-87,Jun_Demand,Nov_Demand,500,1.1959247602040566
470,ITM_471,Sometimes Building,Grocery,1646,1373,1524,1506,1751,1385,1387,1109,1652,1389,1300,1936,17958,100,1795800,466556848,43.51040872511944,43.51040872511944,290,Dec_Demand,Aug_Demand,827,1.7457168462965118
471,ITM_472,After Phone,Grocery,1826,1480,1600,1365,1218,1307,1389,1551,1536,1683,1259,1315,17529,50,876450,467433298,43.59214516922181,43.59214516922181,-511,Jan_Demand,May_Demand,608,1.4991789696290725
472,ITM_473,That Themselves,Home & Kitchen,318,332,324,328,320,328,323,343,371,342,307,334,3970,2,7940,467441238,43.59288564199969,43.59288564199969,16,Sep_Demand,Nov_Demand,64,1.2084690160107814
473,ITM_474,Design Run,Electronics,100,117,127,109,105,108,114,109,109,108,122,119,1347,10,13470,467454708,43.59414183448307,43.59414183448307,19,Mar_Demand,Jan_Demand,27,1.2699998730000126
474,ITM_475,Pattern Contain,Grocery,4266,3539,4405,4224,3925,3988,3962,4025,3898,4206,4269,3667,48374,10,483740,467938448,43.63925471881199,43.63925471881199,-599,Mar_Demand,Feb_Demand,866,1.2447018896730662
475,ITM_476,Stage Street,Electronics,129,130,149,156,140,129,124,129,131,132,162,134,1645,2,3290,467941738,43.639561539396276,43.639561539396276,5,Nov_Demand,Jul_Demand,38,1.3064515075442333
476,ITM_477,Stock Lose,Grocery,3945,4096,3731,3842,3891,3979,3926,3687,4097,4062,3918,4227,47401,10,474010,468415748,43.683767018167416,43.683767018167416,282,Dec_Demand,Aug_Demand,540,1.1464605339125018
477,ITM_478,Peace Central,Home & Kitchen,158,175,181,190,181,183,191,168,171,161,202,173,2134,2,4268,468420016,43.68416504560016,43.68416504560016,15,Nov_Demand,Jan_Demand,44,1.2784809317417132
478,ITM_479,General Form,Grocery,1675,1603,1682,1662,1446,2109,1570,1704,1674,1809,1694,1693,20321,2,40642,468460658,43.687955259030716,43.687955259030716,18,Jun_Demand,May_Demand,663,1.4585062139799017
479,ITM_480,Become Expect,Home & Kitchen,420,361,390,358,381,405,419,428,406,395,400,425,4788,10,47880,468508538,43.692420477746694,43.692420477746694,5,Aug_Demand,Apr_Demand,70,1.1955306928622713
480,ITM_481,Trip Mind,Grocery,4178,3974,4151,4005,3995,3786,4301,3615,4145,4234,3826,3974,48184,10,481840,468990378,43.73735617085673,43.73735617085673,-204,Jul_Demand,Aug_Demand,686,1.1897648653118538
481,ITM_482,Society Add,Toys,533,513,540,532,507,506,550,506,459,475,454,502,6077,500,3038500,472028878,44.02072223327336,44.02072223327336,-31,Jul_Demand,Nov_Demand,96,1.2114537178093896
482,ITM_483,Along Have,Home & Kitchen,45,53,76,60,51,69,60,57,60,76,56,65,728,2,1456,472030334,44.020858017702146,44.020858017702146,20,Mar_Demand,Jan_Demand,31,1.6888885135803302
483,ITM_484,Reach Operation,Electronics,74,71,79,84,77,66,66,82,77,92,82,90,940,2,1880,472032214,44.02103334375031,44.02103334375031,16,Oct_Demand,Jun_Demand,26,1.3939391827364873
484,ITM_485,Be Loss,Electronics,404,354,351,410,361,381,363,365,367,380,389,340,4465,2,8930,472041144,44.021866142479084,44.021866142479084,-64,Apr_Demand,Dec_Demand,70,1.2058823174740496
485,ITM_486,Attention Final,Toys,424,447,384,438,386,432,435,458,451,431,409,427,5122,2,10244,472051388,44.0228214829245,44.0228214829245,3,Aug_Demand,Mar_Demand,74,1.1927083022732214
486,ITM_487,Woman Above,Grocery,878,1125,1250,1185,527,939,1057,770,1318,1204,879,973,12105,1000,12105000,484156388,45.15171606431444,45.15171606431444,95,Sep_Demand,May_Demand,791,2.5009487191470834
487,ITM_488,Player General,Electronics,415,408,401,436,383,372,423,414,424,416,425,395,4912,2,9824,484166212,45.15263223617463,45.15263223617463,-20,Apr_Demand,Jun_Demand,64,1.1720429792461566
488,ITM_489,Lose American,Grocery,4584,4559,4686,4601,4674,5064,4562,4725,4656,5053,4384,4461,56009,2,112018,484278230,45.16307887088906,45.16307887088906,-123,Jun_Demand,Nov_Demand,680,1.155109486416265
489,ITM_490,Money Popular,Electronics,371,382,396,360,367,372,364,349,352,367,327,360,4367,10,43670,484321900,45.1671514711674,45.1671514711674,-11,Mar_Demand,Nov_Demand,69,1.211009137278008
490,ITM_491,Great That,Apparel,401,636,351,239,230,200,235,259,606,660,725,613,5155,2,10310,484332210,45.168112966676205,45.168112966676205,212,Nov_Demand,Jun_Demand,525,3.624999818750009
491,ITM_492,Recognize Dinner,Grocery,2427,2307,2549,2268,2697,2407,2522,2405,2205,2370,2615,1866,28638,10,286380,484618590,45.19482034628946,45.19482034628946,-561,May_Demand,Dec_Demand,831,1.445337612833132
492,ITM_493,Police Actually,Toys,122,112,102,99,108,121,123,108,120,91,127,111,1344,50,67200,484685790,45.201087319925925,45.201087319925925,-11,Nov_Demand,Oct_Demand,36,1.395604242241292
493,ITM_494,Yes Enter,Electronics,312,297,327,358,310,302,283,321,323,310,330,283,3756,50,187800,484873590,45.21860127303498,45.21860127303498,-29,Apr_Demand,Jul_Demand,75,1.2650176231442538
494,ITM_495,Animal Sell,Home & Kitchen,380,396,386,380,410,411,412,385,393,423,377,405,4758,2,9516,484883106,45.219488721265996,45.219488721265996,25,Oct_Demand,Nov_Demand,46,1.122015885357669
495,ITM_496,School Environment,Apparel,166,29,134,353,17,125,375,109,160,76,254,388,2186,2,4372,484887478,45.219896447586514,45.219896447586514,222,Dec_Demand,May_Demand,371,22.823515986167067
496,ITM_497,History Write,Toys,240,262,238,269,246,229,234,257,278,257,231,245,2986,50,149300,485036778,45.23381994704967,45.23381994704967,5,Sep_Demand,Jun_Demand,49,1.2139737461146836
497,ITM_498,Away Ago,Apparel,344,374,376,120,18,160,82,22,35,210,12,16,1769,2,3538,485040316,45.234149895750946,45.234149895750946,-328,Mar_Demand,Nov_Demand,364,31.33330722224398
498,ITM_499,Management Choice,Grocery,3679,3644,3608,3730,3596,3726,3564,3478,3783,3767,3306,3597,43478,2,86956,485127272,45.242259285029704,45.242259285029704,-82,Sep_Demand,Nov_Demand,477,1.1442831181358646
499,ITM_500,Stand Often,Grocery,1983,1673,1748,1235,1564,1241,1460,1475,1483,1154,1499,1766,18281,100,1828100,486955372,45.41274521516097,45.41274521516097,-217,Jan_Demand,Oct_Demand,829,1.7183708689915869
500,ITM_501,Box Represent,Electronics,412,512,480,495,485,449,443,403,444,424,479,474,5500,2,11000,486966372,45.41377105905979,45.41377105905979,62,Feb_Demand,Aug_Demand,109,1.2704714324945054
501,ITM_502,Many Which,Grocery,3922,3937,3687,3677,4007,3731,3565,4217,3814,4236,3975,3916,46684,10,466840,487433212,45.457307874125966,45.457307874125966,-6,Oct_Demand,Jul_Demand,671,1.1882187904958799
502,ITM_503,Look Resource,Electronics,454,476,499,503,470,526,495,475,505,499,484,493,5879,10,58790,487492002,45.462790543472515,45.462790543472515,39,Jun_Demand,Jan_Demand,72,1.1585902828504344
503,ITM_504,No Half,Grocery,1433,1101,1174,1262,972,1260,1384,1276,1495,1397,852,1053,14659,2,29318,487521320,45.46552469723849,45.46552469723849,-380,Sep_Demand,Nov_Demand,643,1.7546948150857418
504,ITM_505,Resource Ground,Electronics,272,269,248,228,252,252,266,240,255,249,273,241,3045,10,30450,487551770,45.468364419667516,45.468364419667516,-31,Nov_Demand,Apr_Demand,45,1.197368368536475
505,ITM_506,Range Law,Grocery,2673,2649,2825,2418,2621,2629,2934,2494,2516,2591,2524,2586,31460,2,62920,487614690,45.4742322467688,45.4742322467688,-87,Jul_Demand,Apr_Demand,516,1.2133994987038894
506,ITM_507,Mission Food,Home & Kitchen,261,280,253,283,285,251,253,263,259,287,259,254,3188,2,6376,487621066,45.47482686319598,45.47482686319598,-7,Oct_Demand,Jun_Demand,36,1.1434262492658864
507,ITM_508,Carry Year,Apparel,372,481,442,472,339,199,314,742,274,210,396,453,4694,2,9388,487630454,45.475702374334354,45.475702374334354,81,Aug_Demand,Jun_Demand,543,3.7286430287114056
508,ITM_509,Hope Customer,Electronics,171,180,172,188,167,178,156,166,155,175,177,149,2034,50,101700,487732154,45.48518676747168,45.48518676747168,-22,Apr_Demand,Dec_Demand,39,1.2617448817620884
509,ITM_510,Situation Son,Electronics,146,169,146,158,142,169,151,146,177,157,133,139,1833,50,91650,487823804,45.49373391231963,45.49373391231963,-7,Sep_Demand,Nov_Demand,44,1.3308269676069948
510,ITM_511,Wall Trial,Electronics,168,160,159,169,185,158,156,146,204,146,156,178,1985,2,3970,487827774,45.49410414870857,45.49410414870857,10,Sep_Demand,Aug_Demand,58,1.3972601782698508
511,ITM_512,Radio Race,Grocery,4185,4087,3660,3774,4391,3906,3699,4155,3936,3646,3959,4208,47606,1000,47606000,535433774,49.93377002575521,49.93377002575521,23,May_Demand,Oct_Demand,745,1.2043335128789536
512,ITM_513,The Television,Home & Kitchen,319,290,300,318,304,301,313,277,328,332,284,300,3666,50,183300,535617074,49.9508643154511,49.9508643154511,-19,Oct_Demand,Aug_Demand,55,1.1985559134095338
513,ITM_514,Official Impact,Electronics,455,445,427,435,433,426,444,421,425,427,412,443,5193,100,519300,536136374,49.99929347332932,49.99929347332932,-12,Jan_Demand,Nov_Demand,43,1.1043689052337644
514,ITM_515,Study Scientist,Electronics,55,57,66,75,70,67,66,62,51,51,69,65,754,50,37700,536174074,50.002809320146206,50.002809320146206,10,Apr_Demand,Sep_Demand,24,1.4705879469435397
515,ITM_516,Bag Southern,Electronics,407,444,429,390,445,433,433,409,410,448,421,423,5092,10,50920,536224994,50.007558044812406,50.007558044812406,16,Oct_Demand,Apr_Demand,58,1.1487179192636432
516,ITM_517,Health Hundred,Grocery,4831,4585,4898,4840,4423,4338,4369,4611,4493,4595,4822,4512,55317,500,27658500,563883494,52.58694926987425,52.58694926987425,-319,Mar_Demand,Jun_Demand,560,1.1290917447462154
517,ITM_518,Decide Clear,Grocery,4722,5014,5247,4869,5006,5462,4881,5053,5142,4726,4890,4802,59814,2,119628,564003122,52.5981056020496,52.5981056020496,80,Jun_Demand,Jan_Demand,740,1.1567132546448258
518,ITM_519,Reflect Or,Grocery,3803,4009,3961,3728,4219,4114,3952,4172,3974,4247,3924,3819,47922,2,95844,564098966,52.607043873198606,52.607043873198606,16,Oct_Demand,Apr_Demand,519,1.139216735141586
519,ITM_520,Bank Happen,Apparel,527,511,828,598,879,659,328,733,652,821,499,443,7478,50,373900,564472866,52.641913239905065,52.641913239905065,-84,May_Demand,Jul_Demand,551,2.6798779670768913
520,ITM_521,Nature Nice,Grocery,3602,3796,3870,3680,3537,3784,3820,4052,3974,4063,3918,3937,46033,100,4603300,569076166,53.07121025985652,53.07121025985652,335,Oct_Demand,May_Demand,526,1.1487135958475725
521,ITM_522,Pattern Book,Grocery,3079,3185,3081,2794,3313,3329,3168,3241,3309,2997,2781,2859,37136,1000,37136000,606212166,56.53445926229327,56.53445926229327,-220,Jun_Demand,Nov_Demand,548,1.197051416047999
522,ITM_523,Nothing May,Grocery,2973,3161,2943,3014,3397,3009,3207,3285,3091,3246,2654,2978,36958,2,73916,606286082,56.541352560259234,56.541352560259234,5,May_Demand,Nov_Demand,743,1.2799547804071032
523,ITM_524,Want Dog,Toys,473,444,440,476,474,458,456,477,464,464,491,460,5577,10,55770,606341852,56.546553588826285,56.546553588826285,-13,Nov_Demand,Mar_Demand,51,1.1159090655475212
524,ITM_525,Likely Guess,Grocery,2415,2729,2530,2101,2348,2496,3059,2959,2172,2541,2386,2422,30158,50,1507900,607849752,56.68717813564808,56.68717813564808,7,Jul_Demand,Apr_Demand,958,1.4559733390957954
525,ITM_526,Begin Here,Electronics,82,77,75,71,69,79,64,78,92,85,70,86,928,50,46400,607896152,56.691505331730404,56.691505331730404,4,Sep_Demand,Jul_Demand,28,1.43749977539066
526,ITM_527,Program Fear,Grocery,1626,1613,1196,1905,1538,1417,1739,1785,1763,2115,2067,2060,20824,10,208240,608104392,56.710925489320545,56.710925489320545,434,Oct_Demand,Mar_Demand,919,1.7683946340435233
527,ITM_528,What Friend,Grocery,4476,5066,5208,4874,5384,4876,4927,5090,4979,4720,4805,4898,59303,10,593030,608697422,56.766230599076984,56.766230599076984,422,May_Demand,Jan_Demand,908,1.2028596934699292
528,ITM_529,Good Seven,Grocery,4108,4173,4384,4587,4389,4361,4366,4412,4009,4233,4106,4361,51489,10,514890,609212312,56.81424848681031,56.81424848681031,253,Apr_Demand,Sep_Demand,578,1.1441756020349823
529,ITM_530,Often Big,Electronics,240,283,242,252,263,278,262,284,276,293,266,256,3195,2,6390,609218702,56.814844408856985,56.814844408856985,16,Oct_Demand,Jan_Demand,53,1.22083328246528
530,ITM_531,Cold Seem,Apparel,797,361,426,468,375,505,728,617,466,573,724,774,6814,2,13628,609232330,56.8161153361891,56.8161153361891,-23,Jan_Demand,Feb_Demand,436,2.2077561715303
531,ITM_532,Then Hand,Grocery,4063,3774,3677,3766,4129,3753,3416,3283,3656,3715,3582,3922,44736,2,89472,609321802,56.824459363945074,56.824459363945074,-141,May_Demand,Aug_Demand,846,1.2576911323250346
532,ITM_533,Ten Generation,Toys,520,471,472,465,498,493,502,492,491,470,469,500,5843,100,584300,609906102,56.87895032667999,56.87895032667999,-20,Jan_Demand,Apr_Demand,55,1.1182795458434507
533,ITM_534,Against Seek,Grocery,2012,2070,2326,2144,1397,2108,1905,2218,2012,2426,1869,1773,24260,50,1213000,611119102,56.992072931159626,56.992072931159626,-239,Oct_Demand,May_Demand,1029,1.736578369816905
534,ITM_535,Sure Until,Electronics,231,213,218,187,196,214,217,227,208,211,200,227,2549,50,127450,611246552,57.00395873160557,57.00395873160557,-4,Jan_Demand,Apr_Demand,44,1.2352940515885533
535,ITM_536,Pm Traditional,Apparel,1054,1264,1245,1139,1018,1030,1038,887,1204,942,919,1177,12917,2,25834,611272386,57.00636797263123,57.00636797263123,123,Feb_Demand,Aug_Demand,377,1.4250281688271909
536,ITM_537,Memory Give,Grocery,1239,925,899,619,1107,829,909,1184,977,681,1020,1186,11575,10,115750,611388136,57.01716264820297,57.01716264820297,-53,Jan_Demand,Apr_Demand,620,2.001615476549023
537,ITM_538,Project Several,Grocery,1445,1435,2165,1687,1835,1673,1664,2003,1830,1913,1616,1953,21219,100,2121900,613510036,57.21504793628652,57.21504793628652,508,Mar_Demand,Feb_Demand,730,1.508710790880064
538,ITM_539,Various General,Toys,233,209,211,188,222,223,249,185,206,202,218,184,2530,10,25300,613535336,57.217407377253814,57.217407377253814,-49,Jul_Demand,Dec_Demand,65,1.353260796018435
539,ITM_540,Around Money,Home & Kitchen,71,81,61,87,89,75,76,76,80,77,104,90,967,50,48350,613583686,57.22191642748184,57.22191642748184,19,Nov_Demand,Mar_Demand,43,1.7049177532921715
540,ITM_541,Thousand Over,Apparel,752,682,378,279,846,773,707,548,612,331,343,794,7045,10,70450,613654136,57.22848649136114,57.22848649136114,42,May_Demand,Apr_Demand,567,3.0322579558330482
541,ITM_542,Understand National,Toys,356,349,366,392,392,369,341,410,397,389,382,363,4506,2,9012,613663148,57.22932693728988,57.22932693728988,7,Aug_Demand,Jul_Demand,69,1.202346005796305
542,ITM_543,Present Maybe,Grocery,4679,4346,4493,4836,4481,4669,4885,4534,4567,4717,4342,4766,55315,10,553150,614216298,57.28091289662039,57.28091289662039,87,Jul_Demand,Nov_Demand,543,1.125057574562281
543,ITM_544,Reach Form,Grocery,894,1169,1217,1024,1089,1206,1079,1016,1394,1201,1223,1001,13513,1000,13513000,627729298,58.54111549706007,58.54111549706007,107,Sep_Demand,Jan_Demand,500,1.5592840988894396
544,ITM_545,Rich Program,Grocery,2654,2776,2104,2643,2444,2642,2506,2385,2207,2533,2600,2494,29988,10,299880,628029178,58.569081866912796,58.569081866912796,-160,Feb_Demand,Mar_Demand,672,1.3193916287101157
545,ITM_546,Enough Them,Home & Kitchen,222,255,214,225,219,231,223,245,239,212,218,216,2719,2,5438,628034616,58.56958900683296,58.56958900683296,-6,Feb_Demand,Oct_Demand,43,1.202830131941975
546,ITM_547,Crime Drop,Grocery,1068,1073,1235,1083,1172,889,933,1410,1233,931,1303,1229,13559,2,27118,628061734,58.57211799181918,58.57211799181918,161,Aug_Demand,Jun_Demand,521,1.5860517256912068
547,ITM_548,Dark Clearly,Grocery,2108,2141,1954,1954,1994,1890,2066,2085,2062,2140,2018,1979,24391,10,243910,628305644,58.594864681397596,58.594864681397596,-129,Feb_Demand,Jun_Demand,251,1.1328042268105596
548,ITM_549,Treat Probably,Grocery,2552,2658,2535,2554,2615,2632,2696,2325,2539,2502,2713,2875,31196,2,62392,628368036,58.60068326799174,58.60068326799174,323,Dec_Demand,Aug_Demand,550,1.2365591344664122
549,ITM_550,Consider North,Grocery,2889,2773,3420,2860,3238,2961,3125,3126,3142,2916,3056,2915,36421,2,72842,628440878,58.60747640628976,58.60747640628976,26,Mar_Demand,Feb_Demand,647,1.2333213082101646
550,ITM_551,Police Clearly,Home & Kitchen,296,313,296,317,295,315,292,341,313,317,305,275,3675,50,183750,628624628,58.624612662326975,58.624612662326975,-21,Aug_Demand,Dec_Demand,66,1.2399999549090928
551,ITM_552,National Since,Home & Kitchen,390,459,422,393,446,398,421,452,412,433,395,441,5062,10,50620,628675248,58.6293334094323,58.6293334094323,51,Feb_Demand,Jan_Demand,69,1.176923046745563
552,ITM_553,Hot Staff,Grocery,1953,2125,1924,2001,2290,2151,1691,2230,2482,2050,2361,2248,25506,2,51012,628726260,58.634090713883836,58.634090713883836,295,Sep_Demand,Jul_Demand,791,1.4677705412905349
553,ITM_554,How Reduce,Apparel,796,906,969,1073,980,960,897,870,640,819,1143,898,10951,100,1095100,629821360,58.73621813693878,58.73621813693878,102,Nov_Demand,Sep_Demand,503,1.785937472094727
554,ITM_555,Almost Approach,Apparel,443,765,898,853,751,630,637,923,511,669,728,919,8727,10,87270,629908630,58.74435680939792,58.74435680939792,476,Aug_Demand,Jan_Demand,480,2.083521397663174
555,ITM_556,Similar His,Grocery,2844,2703,2473,2686,2780,3265,3023,2723,2211,2530,2629,2701,32568,2,65136,629973766,58.75043129741555,58.75043129741555,-143,Jun_Demand,Sep_Demand,1054,1.4767073655508485
556,ITM_557,Southern Onto,Grocery,1650,1228,1151,1312,1266,846,1071,805,894,1235,927,1394,13779,2,27558,630001324,58.75300131615772,58.75300131615772,-256,Jan_Demand,Aug_Demand,845,2.0496894155318084
557,ITM_558,Here Plant,Grocery,1405,1861,1552,1456,1357,1343,1669,1573,1359,1709,1548,1329,18161,2,36322,630037646,58.75638865271164,58.75638865271164,-76,Feb_Demand,Dec_Demand,532,1.400300967642581
558,ITM_559,Author Sit,Apparel,506,216,214,122,34,454,20,393,342,395,412,260,3368,50,168400,630206046,58.77209339021731,58.77209339021731,-246,Jan_Demand,Jul_Demand,486,25.299987350006326
559,ITM_560,Able Develop,Grocery,3060,3131,2620,2620,2669,2755,3456,2829,2787,2990,2867,2560,34344,100,3434400,633640446,59.09238050713805,59.09238050713805,-500,Jul_Demand,Dec_Demand,896,1.3499999947265624
560,ITM_561,Plan Number,Grocery,1138,942,1020,1456,864,896,1492,1063,1251,1134,1095,958,13309,10,133090,633773536,59.104792285728486,59.104792285728486,-180,Jul_Demand,May_Demand,628,1.726851831865141
561,ITM_562,Central Front,Apparel,704,646,699,292,828,512,528,334,257,469,749,716,6734,10,67340,633840876,59.11107231556003,59.11107231556003,12,May_Demand,Sep_Demand,571,3.221789757907014
562,ITM_563,Forget Would,Toys,161,124,156,173,165,174,166,159,143,143,162,160,1886,2,3772,633844648,59.11142408675879,59.11142408675879,-1,Jun_Demand,Feb_Demand,50,1.4032256932882505
563,ITM_564,Apply Always,Grocery,3728,3174,3739,3529,3576,3852,3580,3561,3409,3421,3570,3495,42634,50,2131700,635976348,59.310223308497655,59.310223308497655,-233,Jun_Demand,Feb_Demand,678,1.2136105821877423
564,ITM_565,Popular World,Electronics,180,206,186,189,199,184,183,181,176,182,180,179,2225,2,4450,635980798,59.310638308984,59.310638308984,-1,Feb_Demand,Sep_Demand,30,1.17045447895145
565,ITM_566,Reach Big,Grocery,4537,4504,4420,4449,4780,4236,4430,4267,4396,4034,4126,4267,52446,10,524460,636505258,59.3595486809093,59.3595486809093,-270,May_Demand,Oct_Demand,746,1.1849281081186709
566,ITM_567,Physical Some,Grocery,3184,3070,3212,2935,3259,3314,3394,2728,3179,3295,3164,3255,37989,50,1899450,638404708,59.53668860760249,59.53668860760249,71,Jul_Demand,Aug_Demand,666,1.244134892800092
567,ITM_568,Cost Very,Home & Kitchen,343,330,314,339,347,311,328,316,311,332,321,349,3941,10,39410,638444118,59.54036392651638,59.54036392651638,6,Dec_Demand,Jun_Demand,38,1.122186459093683
568,ITM_569,Worry Because,Toys,50,65,61,60,51,55,48,51,54,55,50,45,645,2,1290,638445408,59.54048423002815,59.54048423002815,-5,Feb_Demand,Dec_Demand,20,1.4444441234568615
569,ITM_570,Likely Recognize,Home & Kitchen,356,307,352,373,374,359,372,355,350,370,343,358,4269,2,8538,638453946,59.54128047141071,59.54128047141071,2,May_Demand,Feb_Demand,67,1.2182410026631596
570,ITM_571,Out Lay,Grocery,2827,2471,2472,3232,2648,2406,2926,2722,2699,2383,2869,2541,32196,2,64392,638518338,59.54728557507737,59.54728557507737,-286,Apr_Demand,Oct_Demand,849,1.3562735990085035
571,ITM_572,Month Wide,Toys,82,106,109,100,107,81,96,97,101,90,89,93,1151,2,2302,638520640,59.54750025622783,59.54750025622783,11,Mar_Demand,Jun_Demand,28,1.345678846212488
572,ITM_573,Toward Activity,Electronics,493,438,431,440,458,444,437,459,490,491,469,434,5484,10,54840,638575480,59.552614554356154,59.552614554356154,-59,Jan_Demand,Mar_Demand,62,1.1438514815811722
573,ITM_574,Program Decide,Apparel,236,447,229,38,308,80,271,446,19,116,19,51,2260,50,113000,638688480,59.56315276895319,59.56315276895319,-185,Feb_Demand,Sep_Demand,428,23.526303407208733
574,ITM_575,Book Reach,Apparel,798,1052,681,814,804,892,1035,933,1253,669,1127,749,10807,500,5403500,644091980,60.067075269617426,60.067075269617426,-49,Sep_Demand,Oct_Demand,584,1.872944665576313
575,ITM_576,Represent Whose,Electronics,451,470,456,500,469,467,451,468,492,436,443,459,5562,100,556200,644648180,60.118945667483516,60.118945667483516,8,Apr_Demand,Oct_Demand,64,1.146788964523189
576,ITM_577,Bed Ago,Grocery,2775,2852,2589,2718,2818,2866,2441,2416,2303,2732,2510,2512,31532,2,63064,644711244,60.12482692381403,60.12482692381403,-263,Jun_Demand,Sep_Demand,563,1.2444637375403222
577,ITM_578,Glass Career,Grocery,4464,3966,4222,4529,4546,4449,4333,4288,4174,4507,4448,4883,52809,10,528090,645239334,60.17407582422594,60.17407582422594,419,Dec_Demand,Feb_Demand,917,1.2312153272031887
578,ITM_579,Dream Character,Home & Kitchen,222,267,258,228,242,262,224,236,269,258,221,272,2959,2,5918,645245252,60.17462772824351,60.17462772824351,50,Dec_Demand,Nov_Demand,51,1.2307691750783178
579,ITM_580,Per Appear,Grocery,3388,3398,3390,3435,3042,3413,3084,3462,3409,3026,3367,3142,39556,100,3955600,649200852,60.54352119426135,60.54352119426135,-246,Aug_Demand,Oct_Demand,436,1.1440845963513397
580,ITM_581,Manage Into,Grocery,3310,3475,3735,3704,3392,3425,3432,3161,3536,3292,3270,3013,40745,500,20372500,669573352,62.443430724155334,62.443430724155334,-297,Mar_Demand,Dec_Demand,722,1.2396282733500554
581,ITM_582,When Water,Apparel,820,554,777,779,796,833,592,877,617,863,942,730,9180,2,18360,669591712,62.44514295088101,62.44514295088101,-90,Nov_Demand,Feb_Demand,388,1.7003609801378885
582,ITM_583,Most Exactly,Grocery,2413,2573,2339,2291,2760,2558,2665,2734,2467,2594,2441,2754,30589,10,305890,669897602,62.473669804536634,62.473669804536634,341,May_Demand,Apr_Demand,469,1.204714093388415
583,ITM_584,Finish Watch,Grocery,3630,3725,3664,3434,3231,3643,3445,3724,3205,3332,3619,3328,41980,2,83960,669981562,62.481499791240765,62.481499791240765,-302,Feb_Demand,Sep_Demand,520,1.1622464862332402
584,ITM_585,Either Clearly,Grocery,4272,3936,3764,3920,4218,3893,3878,4074,4209,4183,3918,4297,48562,2,97124,670078686,62.490557433316184,62.490557433316184,25,Dec_Demand,Mar_Demand,533,1.1416046728437708
585,ITM_586,Hope Dark,Grocery,1316,1372,1219,1307,1182,1214,1320,1155,1072,1241,1425,946,14769,10,147690,670226376,62.50433078653597,62.50433078653597,-370,Nov_Demand,Dec_Demand,479,1.5063424787913058
586,ITM_587,And Field,Grocery,1235,1344,1264,959,1549,1124,1373,1303,1122,1107,987,1188,14555,500,7277500,677503876,63.18301978414566,63.18301978414566,-47,May_Demand,Apr_Demand,590,1.6152241750237313
587,ITM_588,Station Recent,Grocery,4691,4352,4242,4244,4421,4365,4319,4616,4495,4181,4409,4393,52728,500,26364000,703867876,65.64168783402293,65.64168783402293,-298,Jan_Demand,Oct_Demand,510,1.1219803847835916
588,ITM_589,Term Around,Electronics,204,202,213,214,227,197,224,270,238,222,205,219,2635,2,5270,703873146,65.64217930650901,65.64217930650901,15,Aug_Demand,Jun_Demand,73,1.3705583060630302
589,ITM_590,Read Role,Apparel,895,1059,1177,1170,792,614,945,1182,1108,1148,1188,1089,12367,2,24734,703897880,65.64448596314479,65.64448596314479,194,Nov_Demand,Jun_Demand,574,1.9348533886831696
590,ITM_591,Music Game,Grocery,4750,4723,4947,4801,4752,4473,4860,4535,4972,4706,4870,4687,57076,10,570760,704468640,65.69771420529878,65.69771420529878,-63,Sep_Demand,Jun_Demand,499,1.1115582358337621
591,ITM_592,Fire Treat,Toys,466,496,467,486,474,501,525,528,466,515,479,500,5903,500,2951500,707420140,65.97296677506107,65.97296677506107,34,Aug_Demand,Jan_Demand,62,1.133047185986112
592,ITM_593,Surface Almost,Toys,300,270,278,284,288,297,300,305,287,274,327,273,3483,50,174150,707594290,65.98920774915021,65.98920774915021,-27,Nov_Demand,Feb_Demand,57,1.2111110662551459
593,ITM_594,Light Response,Apparel,219,136,7,187,168,395,305,235,16,118,12,197,1995,10,19950,707614240,65.99106825694854,65.99106825694854,-22,Jun_Demand,Mar_Demand,388,56.428490816441695
594,ITM_595,Star Thing,Apparel,342,160,126,96,172,313,7,304,12,86,140,179,1937,10,19370,707633610,65.99287467479583,65.99287467479583,-163,Jan_Demand,Jul_Demand,335,48.8570730613242
595,ITM_596,Gun Team,Grocery,2197,2634,2792,2656,2448,2433,2633,2587,2753,2581,2717,2779,31210,10,312100,707945710,66.02198066396161,66.02198066396161,582,Mar_Demand,Jan_Demand,595,1.2708238449211475
596,ITM_597,Evening He,Electronics,509,498,507,540,503,495,475,474,501,470,492,498,5962,10,59620,708005330,66.02754073789325,66.02754073789325,-11,Apr_Demand,Oct_Demand,70,1.1489361457673162
597,ITM_598,Player Care,Toys,268,231,233,230,281,258,270,244,279,252,225,255,3026,2,6052,708011382,66.02810513855468,66.02810513855468,-13,May_Demand,Nov_Demand,56,1.2488888333827184
598,ITM_599,Ready Wife,Grocery,2972,2928,2625,2951,2991,2655,2600,3055,3322,3350,3027,2975,35451,10,354510,708365892,66.06116622224312,66.06116622224312,3,Oct_Demand,Jul_Demand,750,1.288461533505917
599,ITM_600,Agency Significant,Grocery,1650,1497,1992,1983,1887,1804,1930,1732,1650,1707,1814,1939,21585,2,43170,708409062,66.06519219325332,66.06519219325332,289,Mar_Demand,Feb_Demand,495,1.3306613137564374
600,ITM_601,Hand Step,Electronics,116,138,154,157,170,139,122,145,139,133,167,146,1726,10,17260,708426322,66.06680183558912,66.06680183558912,30,May_Demand,Jan_Demand,54,1.465517115041628
601,ITM_602,Sing Lot,Apparel,1084,990,971,1109,732,1235,676,1015,1228,1115,1003,1044,12202,2,24404,708450726,66.06907771690793,66.06907771690793,-40,Jun_Demand,Jul_Demand,559,1.8269230498975881
602,ITM_603,Information Item,Grocery,1664,2003,1972,1728,2004,2101,1928,2065,1937,1918,1929,2001,23250,2,46500,708497226,66.07341423884388,66.07341423884388,337,Jun_Demand,Jan_Demand,437,1.2626201847198306
603,ITM_604,Expert Marriage,Apparel,396,434,117,146,564,255,484,523,156,129,531,588,4323,50,216150,708713376,66.09357207145581,66.09357207145581,192,Dec_Demand,Mar_Demand,471,5.025640596099095
604,ITM_605,Born Happen,Apparel,583,815,499,612,571,797,793,819,951,916,1051,1027,9434,1000,9434000,718147376,66.97337310250353,66.97337310250353,444,Nov_Demand,Mar_Demand,552,2.1062123826410346
605,ITM_606,By Suffer,Electronics,213,173,176,205,218,171,204,201,187,183,195,161,2287,50,114350,718261726,66.98403721612452,66.98403721612452,-52,May_Demand,Dec_Demand,57,1.354037182979057
606,ITM_607,Property Consider,Electronics,488,496,483,490,482,479,465,474,450,455,473,480,5715,100,571500,718833226,67.03733446959534,67.03733446959534,-8,Feb_Demand,Sep_Demand,46,1.1022221977283957
607,ITM_608,Unit Face,Grocery,2171,2644,2371,2414,2490,2600,2581,2715,2633,2516,2569,2416,30120,2,60240,718893466,67.04295236381945,67.04295236381945,245,Aug_Demand,Jan_Demand,544,1.2505757657734877
608,ITM_609,Hit Appear,Home & Kitchen,337,327,351,300,312,314,304,306,284,307,333,341,3816,2,7632,718901098,67.04366411296817,67.04366411296817,4,Mar_Demand,Sep_Demand,67,1.235915449439597
609,ITM_610,Weight First,Grocery,1955,2629,1876,1693,1703,1981,1871,2279,2228,2361,2088,2321,24985,10,249850,719150948,67.06696475825196,67.06696475825196,366,Feb_Demand,Apr_Demand,936,1.5528647279807164
610,ITM_611,Film City,Grocery,3002,2900,3156,2853,2593,2976,2955,3044,3131,2826,3287,3046,35769,2,71538,719222486,67.07363628741871,67.07363628741871,44,Nov_Demand,May_Demand,694,1.2676436511082003
611,ITM_612,Example Firm,Grocery,3954,3754,3912,3796,4223,4078,3779,4045,4339,4166,3742,4181,47969,2,95938,719318424,67.08258332487011,67.08258332487011,227,Sep_Demand,Nov_Demand,597,1.1595403496538206
612,ITM_613,Region Six,Electronics,110,100,87,79,95,96,80,95,105,95,88,86,1116,10,11160,719329584,67.08362409013475,67.08362409013475,-24,Jan_Demand,Apr_Demand,31,1.392404887037356
613,ITM_614,Research List,Home & Kitchen,439,501,453,434,438,491,444,432,452,441,430,470,5425,10,54250,719383834,67.08868336572668,67.08868336572668,31,Feb_Demand,Nov_Demand,71,1.1651162519740408
614,ITM_615,Check West,Electronics,304,273,295,252,272,277,277,303,247,247,299,275,3321,10,33210,719417044,67.09178048171577,67.09178048171577,-29,Jan_Demand,Sep_Demand,57,1.230769180940519
615,ITM_616,Collection Hundred,Apparel,799,631,747,764,568,829,636,886,778,708,774,766,8886,10,88860,719505904,67.10006743524757,67.10006743524757,-33,Aug_Demand,May_Demand,318,1.5598591274672688
616,ITM_617,Itself Follow,Grocery,1192,964,1006,727,1201,712,1184,1198,1120,790,1170,1421,12685,50,634250,720140154,67.15921666186851,67.15921666186851,229,Dec_Demand,Jun_Demand,709,1.9957864888232235
617,ITM_618,Week Response,Toys,88,87,75,84,70,74,70,105,79,88,83,76,979,2,1958,720142112,67.1593992620825,67.1593992620825,-12,Aug_Demand,May_Demand,35,1.4999997857143164
618,ITM_619,Customer Read,Grocery,2188,2264,2385,2095,2216,2041,2117,2169,2016,2174,2098,2267,26030,500,13015000,733157112,68.37315911146624,68.37315911146624,79,Mar_Demand,Sep_Demand,369,1.1830357084174816
619,ITM_620,Modern Alone,Grocery,1681,1584,1720,1308,1187,1425,1452,1623,1187,1531,1359,1324,17381,2,34762,733191874,68.3764009647036,68.3764009647036,-357,Mar_Demand,May_Demand,533,1.449031158811869
620,ITM_621,However Moment,Apparel,631,455,408,371,510,853,836,295,488,401,800,481,6529,10,65290,733257164,68.38248981453582,68.38248981453582,-150,Jun_Demand,Aug_Demand,558,2.8915253257110063
621,ITM_622,Pass Event,Grocery,2311,2366,2460,2382,2359,2381,2496,2180,2449,2136,2259,2269,28048,2,56096,733313260,68.38772124538569,68.38772124538569,-42,Jul_Demand,Oct_Demand,360,1.168539320372007
622,ITM_623,Notice Social,Grocery,4066,4501,4035,4631,4441,3912,4309,4314,4325,4535,4181,4225,51475,2,102950,733416210,68.39732221169334,68.39732221169334,159,Apr_Demand,Jun_Demand,719,1.183793453006663
623,ITM_624,Experience Language,Grocery,3760,3756,3239,3017,3288,3619,3674,3507,3175,3361,3740,3761,41897,10,418970,733835180,68.4363947406289,68.4363947406289,1,Dec_Demand,Apr_Demand,744,1.2466025812177572
624,ITM_625,Baby Result,Home & Kitchen,112,113,114,109,115,117,112,123,93,128,128,98,1362,2,2724,733837904,68.43664877688165,68.43664877688165,-14,Oct_Demand,Sep_Demand,35,1.3763439380275335
625,ITM_626,Tend Care,Apparel,226,580,540,458,442,285,197,261,580,394,349,504,4816,100,481600,734319504,68.48156208794299,68.48156208794299,278,Feb_Demand,Jul_Demand,383,2.944162287098361
626,ITM_627,Natural Already,Grocery,3325,2814,3126,3435,3459,3194,3453,3258,2987,3127,2874,2883,37935,2,75870,734395374,68.4886376130888,68.4886376130888,-442,May_Demand,Feb_Demand,645,1.229211083051844
627,ITM_628,Somebody Rest,Home & Kitchen,470,503,476,468,489,483,488,440,470,498,506,464,5755,50,287750,734683124,68.51547275689673,68.51547275689673,-6,Nov_Demand,Aug_Demand,66,1.149999973863637
628,ITM_629,Itself Pressure,Apparel,398,66,18,14,132,192,114,133,115,11,327,102,1622,50,81100,734764224,68.52303602418716,68.52303602418716,-296,Jan_Demand,Oct_Demand,387,36.181785289286104
629,ITM_630,Total Key,Toys,278,274,309,313,298,301,321,286,335,297,317,292,3621,10,36210,734800434,68.52641291578503,68.52641291578503,14,Sep_Demand,Feb_Demand,61,1.222627692604829
630,ITM_631,Guess Interview,Grocery,3732,3953,3808,3911,3837,4240,4215,3720,3950,3872,3920,3786,46944,10,469440,735269874,68.57019220304547,68.57019220304547,54,Jun_Demand,Aug_Demand,520,1.139784943172621
631,ITM_632,Store Wear,Grocery,4869,5171,4997,5186,4993,4702,4887,4851,4865,4669,4819,4809,58818,10,588180,735858054,68.62504500890105,68.62504500890105,-60,Apr_Demand,Oct_Demand,517,1.1107303467322118
632,ITM_633,Forget Thus,Toys,146,174,163,150,160,187,157,172,180,183,139,168,1979,10,19790,735877844,68.62689059533359,68.62689059533359,22,Jun_Demand,Nov_Demand,48,1.3453236442213206
633,ITM_634,Tree Similar,Apparel,701,558,222,660,473,486,580,548,569,721,655,236,6409,500,3204500,739082344,68.92573757476886,68.92573757476886,-465,Oct_Demand,Mar_Demand,499,3.2477476014528106
634,ITM_635,Huge Success,Grocery,2813,3238,3151,2828,2746,2848,2632,2622,2829,2951,2935,3419,35012,10,350120,739432464,68.95838925348313,68.95838925348313,606,Dec_Demand,Aug_Demand,797,1.3039664328605398
635,ITM_636,Season Buy,Grocery,2735,2613,3102,2815,2949,2880,2910,2864,2803,3043,3110,2676,34500,10,345000,739777464,68.99056344849177,68.99056344849177,-59,Nov_Demand,Feb_Demand,497,1.1902028274389482
636,ITM_637,News Respond,Grocery,2831,2805,2973,3063,2707,3157,3136,2881,2830,2663,2602,2823,34471,2,68942,739846406,68.99699287849839,68.99699287849839,-8,Jun_Demand,Nov_Demand,555,1.2132974588266814
637,ITM_638,Until Staff,Electronics,102,93,87,97,110,94,109,97,80,82,102,89,1142,50,57100,739903506,69.00231794091867,69.00231794091867,-13,May_Demand,Sep_Demand,30,1.3749998281250215
638,ITM_639,Set Maybe,Apparel,419,643,257,683,327,771,608,488,704,818,684,633,7035,2,14070,739917576,69.0036300885238,69.0036300885238,214,Oct_Demand,Mar_Demand,561,3.182879253584465
639,ITM_640,President Interest,Toys,293,275,299,282,277,252,293,268,250,290,250,297,3326,2,6652,739924228,69.00425044430698,69.00425044430698,4,Mar_Demand,Sep_Demand,49,1.195999952160002
640,ITM_641,Sort Yet,Grocery,2623,2664,2541,2803,2858,2579,2727,2402,2482,2805,2768,2741,31993,10,319930,740244158,69.03408664781166,69.03408664781166,118,May_Demand,Aug_Demand,456,1.1898417935477026
641,ITM_642,Simply Check,Grocery,3774,4130,4063,4000,4581,4432,4276,3840,4172,4077,4082,4020,49447,10,494470,740738628,69.08020019623461,69.08020019623461,246,May_Demand,Jan_Demand,807,1.2138314753210613
642,ITM_643,In Soon,Grocery,3875,3838,4437,4156,4073,4115,3541,3837,3963,4041,3871,3670,47417,10,474170,741212798,69.12442059637155,69.12442059637155,-205,Mar_Demand,Jul_Demand,896,1.2530358620360467
643,ITM_644,Wear Worry,Grocery,3975,3428,3486,3808,3603,3720,3643,3639,3776,3396,3676,3673,43823,10,438230,741651028,69.16528928471541,69.16528928471541,-302,Jan_Demand,Oct_Demand,579,1.1704946961999567
644,ITM_645,Herself Notice,Apparel,811,1096,516,726,577,582,1057,698,905,839,543,650,9000,50,450000,742101028,69.20725562603103,69.20725562603103,-161,Feb_Demand,Mar_Demand,580,2.1240309665885473
645,ITM_646,Remain Employee,Electronics,290,276,280,313,281,293,275,282,322,299,318,279,3508,10,35080,742136108,69.21052713548292,69.21052713548292,-11,Sep_Demand,Jul_Demand,47,1.1709090483305802
646,ITM_647,Vote Source,Home & Kitchen,63,57,54,61,52,55,59,55,68,57,65,63,709,10,7090,742143198,69.21118833850498,69.21118833850498,0,Sep_Demand,May_Demand,16,1.307692056213066
647,ITM_648,Measure Begin,Grocery,2933,2953,3100,2795,2641,2754,2797,2780,3384,2676,2901,3186,34900,500,17450000,759593198,70.83854979618813,70.83854979618813,253,Sep_Demand,May_Demand,743,1.2813328236223671
648,ITM_649,Century Beat,Grocery,4019,4046,4081,3895,3918,4369,3817,3904,3798,4505,3642,3998,47992,2,95984,759689182,70.84750112353221,70.84750112353221,-21,Oct_Demand,Nov_Demand,863,1.236957712144542
649,ITM_650,His Walk,Apparel,60,28,279,83,9,200,253,208,152,36,257,427,1992,2,3984,759693166,70.84787266554066,70.84787266554066,367,Dec_Demand,May_Demand,418,47.44439172845364
650,ITM_651,About Response,Grocery,5084,4737,5271,4872,4551,4683,4957,4804,5185,4583,4527,5053,58307,100,5830700,765523866,71.39163521289385,71.39163521289385,-31,Mar_Demand,Nov_Demand,744,1.164347247262321
651,ITM_652,Mrs No,Grocery,4382,3896,3698,4298,4161,3945,4076,4270,4140,4143,3994,3845,48848,100,4884800,770408666,71.84718451080163,71.84718451080163,-537,Jan_Demand,Mar_Demand,684,1.1849648426582886
652,ITM_653,Effort Give,Grocery,4176,4458,3916,3807,4244,4014,4001,4176,4333,4066,4123,4220,49534,10,495340,770904006,71.89337919415112,71.89337919415112,44,Feb_Demand,Apr_Demand,651,1.1710007849461497
653,ITM_654,Mean Agent,Grocery,4879,4707,4540,4906,4787,4710,4612,4514,4270,4672,4902,4722,56221,50,2811050,773715056,72.15553360249612,72.15553360249612,-157,Apr_Demand,Sep_Demand,636,1.1489461331406414
654,ITM_655,Who Something,Grocery,2348,2852,2556,2499,2139,2503,2542,2495,2590,2452,2169,2364,29509,50,1475450,775190506,72.29313190981638,72.29313190981638,16,Feb_Demand,May_Demand,713,1.3333333270998908
655,ITM_656,Would Son,Grocery,1538,1601,1583,1702,1643,1356,1861,1824,1526,1335,1695,1491,19155,10,191550,775382056,72.31099558243639,72.31099558243639,-47,Jul_Demand,Oct_Demand,526,1.3940074801947004
656,ITM_657,West Fear,Apparel,700,279,867,608,357,583,473,449,858,852,344,613,6983,10,69830,775451886,72.31750782602322,72.31750782602322,-87,Mar_Demand,Feb_Demand,588,3.1075267703395424
657,ITM_658,Painting Mention,Electronics,369,340,373,384,340,377,386,352,369,342,373,356,4361,50,218050,775669936,72.33784284985404,72.33784284985404,-13,Jul_Demand,Feb_Demand,46,1.1352940842560564
658,ITM_659,Perhaps College,Grocery,4582,4425,4990,4646,4466,4506,4815,4402,4930,4334,4455,4924,55475,2,110950,775780886,72.34818988445174,72.34818988445174,342,Mar_Demand,Oct_Demand,656,1.1513613263697247
659,ITM_660,Teach Team,Apparel,778,516,659,960,749,716,678,933,546,641,834,438,8448,2,16896,775797782,72.34976558068034,72.34976558068034,-340,Apr_Demand,Dec_Demand,522,2.1917807718771516
660,ITM_661,Product Treat,Apparel,929,1183,1228,787,933,777,940,1072,1211,1011,941,1228,12240,50,612000,776409782,72.40683980486956,72.40683980486956,299,Mar_Demand,Jun_Demand,451,1.5804375600973288
661,ITM_662,All Every,Electronics,253,233,219,249,234,243,250,226,227,238,234,225,2831,50,141550,776551332,72.42004055067673,72.42004055067673,-28,Jan_Demand,Mar_Demand,34,1.15525108880132
662,ITM_663,Others Boy,Toys,193,170,184,167,169,173,192,191,166,166,143,190,2104,2,4208,776555540,72.4204329825973,72.4204329825973,-3,Jan_Demand,Nov_Demand,50,1.349650255269213
663,ITM_664,Play Present,Grocery,1964,1801,1628,1897,1624,1772,1901,1644,1952,2320,1650,1794,21947,10,219470,776775010,72.44090043354961,72.44090043354961,-170,Oct_Demand,May_Demand,696,1.4285714197748065
664,ITM_665,Sell Such,Electronics,195,237,212,221,239,208,222,205,214,186,227,222,2588,100,258800,777033810,72.4650357427329,72.4650357427329,27,May_Demand,Oct_Demand,53,1.2849461674760125
665,ITM_666,Require Operation,Home & Kitchen,269,290,280,313,309,337,306,321,303,294,303,289,3614,2,7228,777041038,72.46570981543296,72.46570981543296,20,Jun_Demand,Jan_Demand,68,1.2527880575171726
666,ITM_667,Drug Director,Electronics,95,93,89,103,105,92,104,97,102,98,109,121,1208,50,60400,777101438,72.47134263102288,72.47134263102288,26,Dec_Demand,Mar_Demand,32,1.3595504090392798
667,ITM_668,Threat Until,Electronics,505,470,455,458,491,441,482,471,494,500,495,510,5772,10,57720,777159158,72.47672551373563,72.47672551373563,5,Dec_Demand,Jun_Demand,69,1.156462558810373
668,ITM_669,Court Author,Grocery,3272,3061,3124,3100,3302,2621,2885,2821,3611,3285,3213,3235,37530,2,75060,777234218,72.48372549946707,72.48372549946707,-37,Sep_Demand,Jun_Demand,990,1.3777184228244241
669,ITM_670,Discuss Relationship,Grocery,1006,1247,1287,1035,1030,1083,1237,792,1027,888,1240,1162,13034,2,26068,777260286,72.48615656299022,72.48615656299022,156,Mar_Demand,Aug_Demand,495,1.6249999794823236
670,ITM_671,Attack Politics,Toys,330,295,260,283,295,274,337,298,301,333,339,307,3652,10,36520,777296806,72.48956236473433,72.48956236473433,-23,Nov_Demand,Mar_Demand,79,1.303846103698227
671,ITM_672,Clear Stand,Electronics,251,187,206,209,204,210,214,206,209,201,184,208,2489,2,4978,777301784,72.4900266057278,72.4900266057278,-43,Jan_Demand,Nov_Demand,67,1.364130360645089
672,ITM_673,Others Find,Grocery,1440,1560,1279,1192,1123,1377,1545,1613,1290,1176,1409,1100,16104,2,32208,777333992,72.49303027666357,72.49303027666357,-340,Aug_Demand,Dec_Demand,513,1.4663636230330581
673,ITM_674,Recognize Assume,Grocery,2143,2234,2305,2260,1970,2088,2391,1775,2271,2304,1885,1871,25497,50,1274850,778608842,72.6119209216107,72.6119209216107,-272,Jul_Demand,Aug_Demand,616,1.3470422459321565
674,ITM_675,Like So,Grocery,4116,3864,4239,4127,4301,3796,4181,3857,3949,4012,3965,4230,48637,2,97274,778706116,72.62099255246655,72.62099255246655,114,May_Demand,Jun_Demand,505,1.1330347704609198
675,ITM_676,Home Perhaps,Grocery,2724,2645,2613,2616,2486,2453,2549,2546,2536,2700,2866,2240,30974,10,309740,779015856,72.64987845148677,72.64987845148677,-484,Nov_Demand,Dec_Demand,626,1.2794642800023914
676,ITM_677,There Care,Apparel,322,8,205,199,406,512,341,498,26,108,9,449,3083,100,308300,779324156,72.67863005821478,72.67863005821478,127,Jun_Demand,Feb_Demand,504,63.999920000100005
677,ITM_678,While Level,Grocery,3743,4072,4050,3644,4049,3562,4092,3442,4094,4033,3930,3815,46526,10,465260,779789416,72.72201952479367,72.72201952479367,72,Sep_Demand,Aug_Demand,652,1.1894247495949308
678,ITM_679,Determine Central,Grocery,1489,1336,1704,1247,1013,1662,1343,1206,1173,1211,1177,1929,16490,2,32980,779822396,72.72509519131943,72.72509519131943,440,Dec_Demand,May_Demand,916,1.9042447985760633
679,ITM_680,Everything On,Electronics,462,410,423,418,441,436,424,461,436,478,467,434,5290,10,52900,779875296,72.73002856788742,72.73002856788742,-28,Oct_Demand,Feb_Demand,68,1.165853630101131
680,ITM_681,Subject Job,Home & Kitchen,198,192,194,203,190,215,197,202,197,186,192,190,2356,100,235600,780110896,72.75200027902955,72.75200027902955,-8,Jun_Demand,Oct_Demand,29,1.1559139163487142
681,ITM_682,History Become,Electronics,352,368,377,362,352,380,370,367,371,344,314,393,4350,100,435000,780545896,72.7925677423013,72.7925677423013,41,Dec_Demand,Nov_Demand,79,1.2515923168282703
682,ITM_683,Machine Approach,Electronics,316,288,273,312,318,323,306,317,306,312,311,312,3694,2,7388,780553284,72.79325673636717,72.79325673636717,-4,Jun_Demand,Mar_Demand,50,1.1831501398113502
683,ITM_684,Think For,Apparel,97,212,103,140,131,57,206,258,44,58,428,76,1810,2,3620,780556904,72.79359433226841,72.79359433226841,-21,Nov_Demand,Sep_Demand,384,9.727270516529428
684,ITM_685,Design Central,Electronics,106,116,100,117,114,114,92,94,116,112,91,91,1263,10,12630,780569534,72.79477218758134,72.79477218758134,-15,Apr_Demand,Nov_Demand,26,1.285714144427017
685,ITM_686,Society Set,Grocery,3905,3546,3933,3812,3313,3374,3467,3827,3184,3616,3688,3640,43305,10,433050,781002584,72.83515779670739,72.83515779670739,-265,Mar_Demand,Sep_Demand,749,1.235238689587818
686,ITM_687,Indicate Common,Home & Kitchen,76,107,107,84,93,96,95,86,102,99,87,100,1132,2,2264,781004848,72.83536893403348,72.83536893403348,24,Feb_Demand,Jan_Demand,31,1.407894551592822
687,ITM_688,Instead Draw,Apparel,344,424,406,767,543,913,331,457,485,925,558,719,6872,2,13744,781018592,72.8366506793558,72.8366506793558,375,Oct_Demand,Jul_Demand,594,2.794561849106893
688,ITM_689,Address Effect,Grocery,1137,1382,588,934,1171,1325,1404,1439,1052,951,859,845,13087,500,6543500,787562092,73.44688791135292,73.44688791135292,-292,Aug_Demand,Mar_Demand,851,2.447278869944237
689,ITM_690,Final Close,Electronics,344,332,338,342,348,356,368,333,331,356,352,359,4159,2,8318,787570410,73.4476636358575,73.4476636358575,15,Jul_Demand,Sep_Demand,37,1.1117824437527963
690,ITM_691,Follow Discover,Apparel,496,366,372,525,145,491,509,334,559,235,469,290,4791,2,9582,787579992,73.44855723915191,73.44855723915191,-206,Sep_Demand,May_Demand,414,3.8551721479191623
691,ITM_692,Heavy Ask,Toys,270,236,279,260,258,279,215,271,275,277,294,269,3183,10,31830,787611822,73.45152565836096,73.45152565836096,-1,Nov_Demand,Jul_Demand,79,1.3674417968631722
692,ITM_693,Prove Share,Apparel,706,873,880,631,936,811,651,1033,763,1016,777,718,9795,2,19590,787631412,73.45335259308624,73.45335259308624,12,Aug_Demand,Apr_Demand,402,1.6370839677165774
693,ITM_694,Republican Individual,Grocery,4176,3853,4488,4318,4238,4568,4291,4630,4356,4459,4314,4721,52412,10,524120,788155532,73.50223125710922,73.50223125710922,545,Dec_Demand,Feb_Demand,868,1.2252790001939293
694,ITM_695,Risk Whether,Electronics,384,384,423,390,393,400,400,411,414,408,421,398,4826,2,9652,788165184,73.50313138850116,73.50313138850116,14,Mar_Demand,Jan_Demand,39,1.1015624713134773
695,ITM_696,Wonder Yard,Home & Kitchen,108,88,114,123,99,99,98,102,102,109,109,115,1266,2,2532,788167716,73.50336751911497,73.50336751911497,7,Apr_Demand,Feb_Demand,35,1.397727113894646
696,ITM_697,Quality Good,Toys,56,75,55,48,57,56,66,43,58,51,56,67,688,50,34400,788202116,73.5065756127622,73.5065756127622,11,Feb_Demand,Aug_Demand,32,1.7441856408870602
697,ITM_698,Cultural Try,Toys,399,407,460,413,441,450,443,395,442,431,425,427,5133,10,51330,788253446,73.51136257342827,73.51136257342827,28,Mar_Demand,Aug_Demand,65,1.1645569325428626
698,ITM_699,Recent Science,Grocery,3267,3272,3474,3649,3448,3535,3669,3448,3442,3210,3516,3174,41104,2,82208,788335654,73.51902917117688,73.51902917117688,-93,Jul_Demand,Dec_Demand,495,1.155954627738013
699,ITM_700,Education Fine,Grocery,1860,2057,1611,1741,2037,1703,1887,1486,1713,1536,1965,1800,21396,10,213960,788549614,73.53898276759442,73.53898276759442,-60,Feb_Demand,Aug_Demand,571,1.3842530189484992
700,ITM_701,Real Coach,Home & Kitchen,338,313,297,333,321,324,333,311,304,331,327,332,3864,50,193200,788742814,73.55700031679925,73.55700031679925,-6,Jan_Demand,Mar_Demand,41,1.138047099729054
701,ITM_702,Hotel Decade,Apparel,1074,774,1138,860,897,755,752,996,1025,1170,1013,1093,11547,10,115470,788858284,73.56776887998083,73.56776887998083,19,Oct_Demand,Jul_Demand,418,1.5558510431402788
702,ITM_703,Although Kind,Grocery,4228,3657,4230,4003,4245,4233,3979,4038,3905,3818,4107,4172,48615,10,486150,789344434,73.61310651738214,73.61310651738214,-56,May_Demand,Feb_Demand,588,1.160787527588768
703,ITM_704,Go Need,Home & Kitchen,446,455,473,466,476,458,462,467,514,467,499,482,5665,2,11330,789355764,73.61416313659792,73.61416313659792,36,Sep_Demand,Jan_Demand,68,1.152466341872952
704,ITM_705,Mind Within,Grocery,4579,4614,4760,4843,5027,5028,4825,4963,4551,4581,5162,4669,57602,50,2880100,792235864,73.88275704687146,73.88275704687146,90,Nov_Demand,Sep_Demand,611,1.134256204934616
705,ITM_706,Decide Pm,Electronics,353,374,354,403,375,412,380,401,357,344,384,368,4505,2,9010,792244874,73.88359730628314,73.88359730628314,15,Jun_Demand,Oct_Demand,68,1.1976743837885355
706,ITM_707,Top Recognize,Apparel,268,726,655,519,206,777,561,323,486,608,775,425,6329,10,63290,792308164,73.88949963904284,73.88949963904284,157,Jun_Demand,May_Demand,571,3.771844477094928
707,ITM_708,Else Include,Grocery,2041,1780,1624,1767,1715,1331,1778,1567,1556,1605,1635,2075,20474,10,204740,792512904,73.90859339175607,73.90859339175607,34,Dec_Demand,Jun_Demand,744,1.55897820015794
708,ITM_709,Son Close,Home & Kitchen,176,163,155,158,145,178,153,170,168,175,148,165,1954,100,195400,792708304,73.92681610974067,73.92681610974067,-11,Jun_Demand,May_Demand,33,1.2275861222354398
709,ITM_710,Recently Candidate,Grocery,4298,4535,4442,4380,4517,4586,4351,4750,4433,4248,4761,4520,53821,2,107642,792815946,73.93685464510044,73.93685464510044,222,Nov_Demand,Oct_Demand,513,1.1207627092260766
710,ITM_711,Leg Often,Electronics,308,326,301,308,308,300,299,329,308,329,298,328,3742,2,7484,792823430,73.93755259198579,73.93755259198579,20,Aug_Demand,Nov_Demand,31,1.1040268085897045
711,ITM_712,Back Smile,Electronics,373,405,402,370,379,403,408,388,394,429,426,412,4789,100,478900,793302330,73.98221410499923,73.98221410499923,39,Oct_Demand,Apr_Demand,59,1.1594594281227182
712,ITM_713,Then Never,Toys,385,364,341,361,367,403,349,368,372,350,348,330,4338,500,2169000,795471330,74.18449187014048,74.18449187014048,-55,Jun_Demand,Dec_Demand,73,1.2212120842056946
713,ITM_714,Success Almost,Apparel,558,370,791,791,831,460,767,789,414,291,644,332,7038,10,70380,795541710,74.19105540592223,74.19105540592223,-226,May_Demand,Oct_Demand,540,2.855670004959794
714,ITM_715,Fight Show,Grocery,1505,1270,1393,1545,1219,1282,1170,1273,1636,1475,1150,1620,16538,2,33076,795574786,74.19414002526747,74.19414002526747,115,Sep_Demand,Nov_Demand,486,1.4226086832816636
715,ITM_716,Write For,Apparel,839,491,905,427,574,359,363,422,686,711,473,594,6844,10,68440,795643226,74.2005226394889,74.2005226394889,-245,Mar_Demand,Jun_Demand,546,2.520891294682694
716,ITM_717,So Bad,Grocery,4933,4681,4578,4638,4268,4619,4233,4902,4594,4506,4493,4683,55128,2,110256,795753482,74.21080495266243,74.21080495266243,-250,Jan_Demand,Jul_Demand,700,1.165367349006928
717,ITM_718,Though Hundred,Grocery,2274,2411,2587,1957,2528,2009,2357,2161,2353,2523,2581,2170,27911,2,55822,795809304,74.21601083067337,74.21601083067337,-104,Mar_Demand,Apr_Demand,630,1.3219213013698452
718,ITM_719,Wonder Two,Grocery,3200,3539,2890,2840,3610,3135,3254,3207,3384,3345,3277,3558,39239,100,3923900,799733204,74.58194800109187,74.58194800109187,358,May_Demand,Apr_Demand,770,1.2711267560875819
719,ITM_720,Billion Conference,Apparel,317,488,530,323,754,658,699,825,823,386,706,797,7306,2,14612,799747816,74.58331069482365,74.58331069482365,480,Aug_Demand,Jan_Demand,508,2.6025235772074584
720,ITM_721,Perform Operation,Grocery,2918,3336,3051,2947,3000,3101,3220,2791,3091,2744,3249,2956,36404,500,18202000,817949816,76.280802571772,76.280802571772,38,Feb_Demand,Oct_Demand,592,1.2157434358026842
721,ITM_722,Today Control,Toys,369,369,370,358,391,365,334,355,361,341,350,325,4288,2,8576,817958392,76.28160235697894,76.28160235697894,-44,May_Demand,Dec_Demand,66,1.2030768860591727
722,ITM_723,Open Body,Electronics,203,205,208,211,219,213,202,200,177,203,182,199,2422,100,242200,818200592,76.30418957446037,76.30418957446037,-4,May_Demand,Sep_Demand,42,1.2372880656899399
723,ITM_724,Threat Local,Electronics,66,59,54,59,62,70,65,49,68,54,58,61,725,50,36250,818236842,76.30757019639968,76.30757019639968,-5,Jun_Demand,Aug_Demand,21,1.4285711370262986
724,ITM_725,Agent Discuss,Apparel,671,725,942,589,789,840,1022,923,747,578,686,976,9488,10,94880,818331722,76.31641856631974,76.31641856631974,305,Jul_Demand,Oct_Demand,444,1.7681660593742896
725,ITM_726,Six Poor,Apparel,504,502,708,810,540,659,511,622,608,938,434,425,7261,50,363050,818694772,76.35027607790781,76.35027607790781,-79,Oct_Demand,Dec_Demand,513,2.2070587715986174
726,ITM_727,Measure Floor,Electronics,141,169,165,166,145,170,156,144,157,163,182,151,1909,10,19090,818713862,76.35205638336495,76.35205638336495,10,Nov_Demand,Jan_Demand,41,1.2907800502992872
727,ITM_728,Run Difference,Grocery,1923,1451,1689,1799,2097,1374,1572,1698,1626,1558,1476,1739,20002,10,200020,818913882,76.37070995578706,76.37070995578706,-184,May_Demand,Jun_Demand,723,1.5262008622547245
728,ITM_729,World Drop,Apparel,73,489,191,418,449,192,22,17,414,428,305,217,3215,2,6430,818920312,76.3713096081752,76.3713096081752,144,Feb_Demand,Aug_Demand,472,28.76468896194767
729,ITM_730,Base Such,Apparel,299,672,440,302,346,707,301,398,712,279,650,750,5856,10,58560,818978872,76.3767708280584,76.3767708280584,451,Dec_Demand,Oct_Demand,471,2.688171946660504
730,ITM_731,Phone Green,Apparel,216,30,175,549,415,107,573,286,477,161,157,145,3291,10,32910,819011782,76.37983996648661,76.37983996648661,-71,Jul_Demand,Feb_Demand,543,19.099993633335455
731,ITM_732,Reason Somebody,Grocery,2724,2685,2671,2704,2799,2603,2907,2573,2863,2311,2939,2692,32471,10,324710,819336492,76.4101219457946,76.4101219457946,-32,Nov_Demand,Oct_Demand,628,1.271743828335163
732,ITM_733,Story Sometimes,Grocery,4611,4183,4662,4294,4259,4336,4287,4764,4623,4087,4195,4360,52661,2,105322,819441814,76.41994412135024,76.41994412135024,-251,Aug_Demand,Oct_Demand,677,1.1656471711141492
733,ITM_734,Every Why,Apparel,272,255,104,219,140,83,109,271,39,415,353,336,2596,2,5192,819447006,76.42042831967049,76.42042831967049,64,Oct_Demand,Sep_Demand,376,10.641022912558226
734,ITM_735,She Mouth,Toys,548,491,502,448,488,486,467,530,489,501,493,514,5957,10,59570,819506576,76.42598373067531,76.42598373067531,-34,Jan_Demand,Apr_Demand,100,1.223214258410396
735,ITM_736,Process Position,Electronics,81,79,88,86,93,89,87,72,67,86,87,80,995,2,1990,819508566,76.42616931516247,76.42616931516247,-1,May_Demand,Sep_Demand,26,1.3880594943194784
736,ITM_737,Action Actually,Grocery,1677,1263,1196,1534,1639,1506,1669,1745,1884,1781,1295,1732,18921,50,946050,820454616,76.51439655338832,76.51439655338832,55,Sep_Demand,Mar_Demand,688,1.5752508229494078
737,ITM_738,Simple Forward,Grocery,1474,1722,1742,1800,1761,1692,1680,1431,1250,1844,1411,1739,19546,2,39092,820493708,76.51804221608768,76.51804221608768,265,Oct_Demand,Sep_Demand,594,1.4751999881984001
738,ITM_739,Music Room,Apparel,424,439,455,530,703,626,673,627,589,607,810,444,6927,10,69270,820562978,76.52450223489419,76.52450223489419,20,Nov_Demand,Jan_Demand,386,1.9103773134344975
739,ITM_740,Single Scene,Toys,393,288,311,347,323,324,330,322,371,347,315,337,4008,2,8016,820570994,76.52524979532083,76.52524979532083,-56,Jan_Demand,Feb_Demand,105,1.3645832859519693
740,ITM_741,Economic Act,Grocery,1043,1431,1292,1223,1531,947,1274,1509,980,1488,1366,1186,15270,50,763500,821334494,76.59645268775299,76.59645268775299,143,May_Demand,Jun_Demand,584,1.6166842490318454
741,ITM_742,Miss Develop,Grocery,4253,4531,4150,4269,3721,4391,3954,4204,4204,4478,4342,4282,50779,50,2538950,823873444,76.83323144838248,76.83323144838248,29,Feb_Demand,May_Demand,810,1.2176834151634415
742,ITM_743,Performance Hotel,Apparel,522,730,894,1045,1115,1081,553,937,953,871,637,787,10125,2,20250,823893694,76.83511993374168,76.83511993374168,265,May_Demand,Jan_Demand,593,2.1360152847506653
743,ITM_744,Make However,Electronics,380,371,365,348,373,343,406,357,333,336,356,349,4317,10,43170,823936864,76.83914590475189,76.83914590475189,-31,Jul_Demand,Sep_Demand,73,1.2192191826060306
744,ITM_745,Long Me,Grocery,1988,2222,1693,1719,2289,2354,2162,1857,2119,1918,1801,1866,23988,2,47976,823984840,76.84362007628735,76.84362007628735,-122,Jun_Demand,Mar_Demand,661,1.3904311790287585
745,ITM_746,Themselves Especially,Electronics,434,496,490,449,429,430,448,462,448,453,463,431,5433,2,10866,823995706,76.84463342354232,76.84463342354232,-3,Feb_Demand,May_Demand,67,1.1561771292266405
746,ITM_747,Majority Machine,Grocery,3586,3244,3091,3393,3618,3224,3234,3101,2803,3198,3419,3048,38959,2,77918,824073624,76.85189994217038,76.85189994217038,-538,May_Demand,Sep_Demand,815,1.2907598955021051
747,ITM_748,End Man,Electronics,384,420,384,415,422,422,410,402,433,417,402,444,4955,2,9910,824083534,76.8528241342647,76.8528241342647,60,Dec_Demand,Jan_Demand,60,1.1562499698893238
748,ITM_749,Seek Nation,Electronics,350,366,367,308,313,339,362,313,359,378,333,362,4150,50,207500,824291034,76.872175280538,76.872175280538,12,Oct_Demand,Apr_Demand,70,1.2272726874262117
749,ITM_750,Government Understand,Home & Kitchen,107,93,128,116,137,109,112,105,84,109,104,116,1320,10,13200,824304234,76.87340629321659,76.87340629321659,9,May_Demand,Sep_Demand,53,1.6309521867914063
750,ITM_751,Or Western,Apparel,455,772,661,689,309,212,318,584,502,547,331,447,5827,2,11654,824315888,76.87449312819813,76.87449312819813,-8,Feb_Demand,Jun_Demand,560,3.6415092621929595
751,ITM_752,Safe Key,Home & Kitchen,288,284,282,297,280,270,261,271,286,247,271,248,3285,1000,3285000,827600888,77.18084741980209,77.18084741980209,-40,Apr_Demand,Oct_Demand,50,1.2024291011162307
752,ITM_753,Few Rate,Electronics,400,421,438,407,433,406,440,402,432,388,461,424,5052,2,10104,827610992,77.18178970405243,77.18178970405243,24,Nov_Demand,Oct_Demand,73,1.1881442992746316
753,ITM_754,Yeah North,Electronics,293,314,294,256,257,291,261,288,276,288,269,252,3339,10,33390,827644382,77.18490360657805,77.18490360657805,-41,Feb_Demand,Dec_Demand,62,1.2460316965860438
754,ITM_755,You Claim,Electronics,124,122,127,133,142,155,158,134,145,121,132,130,1623,2,3246,827647628,77.18520632378673,77.18520632378673,6,Jul_Demand,Oct_Demand,37,1.305785016050825
755,ITM_756,Unit Respond,Grocery,1363,1518,1476,1613,1819,1680,1446,1495,1510,1959,1624,1379,18882,100,1888200,829535828,77.36129709194704,77.36129709194704,16,Oct_Demand,Jan_Demand,596,1.437270715794052
756,ITM_757,Interest The,Home & Kitchen,357,359,377,380,366,373,364,382,381,378,360,353,4430,10,44300,829580128,77.36542844510322,77.36542844510322,-4,Aug_Demand,Dec_Demand,29,1.0821529438483586
757,ITM_758,Tonight Factor,Apparel,462,151,556,379,329,511,122,256,171,82,267,273,3559,10,35590,829615718,77.3687475164086,77.3687475164086,-189,Mar_Demand,Oct_Demand,474,6.780486977989392
758,ITM_759,Per West,Grocery,3053,3104,2980,2803,2958,2984,2833,2558,2665,2770,2703,3148,34559,10,345590,829961308,77.40097673395363,77.40097673395363,95,Dec_Demand,Aug_Demand,590,1.2306489396769
759,ITM_760,She Spring,Grocery,4419,4346,4592,4721,4570,4302,4953,4818,4652,4423,4407,4870,55073,10,550730,830512038,77.4523370076264,77.4523370076264,451,Jul_Demand,Jun_Demand,651,1.1513249624562414
760,ITM_761,Their Old,Apparel,344,756,584,469,414,775,239,517,550,368,658,247,5921,10,59210,830571248,77.45785884555818,77.45785884555818,-97,Jun_Demand,Jul_Demand,536,3.2426776885908914
761,ITM_762,Industry Entire,Grocery,3603,3725,3858,3724,3830,3790,3494,3799,3803,3715,3688,3815,44844,2,89688,830660936,77.46622301715799,77.46622301715799,212,Mar_Demand,Jul_Demand,364,1.1041785887115667
762,ITM_763,People Candidate,Toys,242,242,254,224,241,242,226,236,237,241,233,211,2829,50,141450,830802386,77.47941443711153,77.47941443711153,-31,Mar_Demand,Dec_Demand,43,1.203791412142587
763,ITM_764,Film It,Grocery,1945,1957,1737,1830,2206,2162,1995,1835,1968,1687,1831,2059,23212,10,232120,831034506,77.50106160854747,77.50106160854747,114,May_Demand,Oct_Demand,519,1.3076467023850225
764,ITM_765,Natural Win,Grocery,3827,3599,3825,3967,3826,3783,3767,3634,3819,3861,4039,4059,46006,10,460060,831494566,77.54396613073784,77.54396613073784,232,Dec_Demand,Feb_Demand,460,1.127813278333389
765,ITM_766,Including Wind,Grocery,1715,1605,1304,2003,1590,1591,1696,1801,1630,1832,1870,1575,20212,10,202120,831696686,77.56281554608609,77.56281554608609,-140,Apr_Demand,Mar_Demand,699,1.5360429330058059
766,ITM_767,Home Enter,Grocery,2969,2918,3232,2950,3043,3374,3633,3125,3373,2632,3345,2646,37240,10,372400,832069086,77.59754502498816,77.59754502498816,-323,Jul_Demand,Oct_Demand,1001,1.3803191436917965
767,ITM_768,Successful A,Apparel,543,505,500,539,408,627,502,560,684,778,564,545,6755,2,13510,832082596,77.598804947813,77.598804947813,2,Oct_Demand,May_Demand,370,1.9068626983612085
768,ITM_769,Tree Deal,Apparel,836,508,950,918,368,885,555,628,469,882,898,433,8330,10,83300,832165896,77.60657338388319,77.60657338388319,-403,Mar_Demand,May_Demand,582,2.5815216689803897
769,ITM_770,Gas Theory,Grocery,3803,3575,3732,3924,3895,3819,3673,3986,3463,3954,3848,4138,45810,2,91620,832257516,77.61511773097504,77.61511773097504,335,Dec_Demand,Sep_Demand,675,1.1949176979644305
770,ITM_771,Modern Former,Toys,436,435,437,452,463,431,441,458,455,430,457,425,5320,2,10640,832268156,77.61611000180082,77.61611000180082,-11,May_Demand,Dec_Demand,38,1.089411739072665
771,ITM_772,Cup Middle,Home & Kitchen,419,419,399,426,452,439,426,427,406,422,412,437,5084,2,10168,832278324,77.61705825459748,77.61705825459748,18,May_Demand,Mar_Demand,53,1.1328320518087205
772,ITM_773,Security Institution,Toys,482,403,407,404,437,440,409,409,445,445,419,439,5139,10,51390,832329714,77.62185081077573,77.62185081077573,-43,Jan_Demand,Feb_Demand,79,1.1960297469967804
773,ITM_774,Green Method,Grocery,4287,4004,4269,4087,3743,4268,4136,3601,3713,4195,4283,3904,48490,10,484900,832814614,77.6670718750067,77.6670718750067,-383,Jan_Demand,Aug_Demand,686,1.1905026348500343
774,ITM_775,Serious Strong,Grocery,879,1227,1358,716,978,848,1117,998,1006,1393,970,957,12447,2,24894,832839508,77.66939345300828,77.66939345300828,78,Oct_Demand,Apr_Demand,677,1.945530699084767
775,ITM_776,Late Human,Grocery,1888,2130,2304,1682,2074,2320,1897,2111,1977,2152,2054,2163,24752,10,247520,833087028,77.6924768059026,77.6924768059026,275,Jun_Demand,Apr_Demand,638,1.379310336627168
776,ITM_777,Low I,Grocery,2711,2604,2265,2333,2528,2612,2483,2416,2596,2547,2406,2304,29805,50,1490250,834577278,77.83145533955945,77.83145533955945,-407,Jan_Demand,Mar_Demand,446,1.196909486989362
777,ITM_778,Late Here,Grocery,1639,1229,1252,1023,1290,990,1083,810,804,1265,1131,473,12989,500,6494500,841071778,78.43712290327998,78.43712290327998,-1166,Jan_Demand,Dec_Demand,1166,3.465116205811497
778,ITM_779,Put Quickly,Electronics,205,187,207,212,194,206,196,192,231,204,209,226,2469,50,123450,841195228,78.44863566958091,78.44863566958091,21,Sep_Demand,Feb_Demand,44,1.2352940515885533
779,ITM_780,Design Law,Grocery,2872,2915,2894,2458,2701,2815,2838,2895,3221,2537,2823,2863,33832,2,67664,841262892,78.45494591517819,78.45494591517819,-9,Sep_Demand,Apr_Demand,763,1.3104149661903377
780,ITM_781,Spring Contain,Grocery,2692,2867,2511,2751,2699,2443,2755,2562,2777,2729,2930,2547,32263,10,322630,841585522,78.48503391673076,78.48503391673076,-145,Nov_Demand,Jun_Demand,487,1.1993450626305973
781,ITM_782,Even Visit,Grocery,3386,3612,3469,3449,3672,3444,3506,3777,3394,3715,3230,3689,42343,2,84686,841670208,78.49293160913221,78.49293160913221,303,Aug_Demand,Nov_Demand,547,1.1693498415809602
782,ITM_783,Key Parent,Home & Kitchen,361,313,316,335,297,322,311,342,316,283,309,352,3857,2,7714,841677922,78.4936510054809,78.4936510054809,-9,Jan_Demand,Oct_Demand,78,1.2756183294834513
783,ITM_784,Blue Book,Home & Kitchen,183,209,205,184,182,177,186,190,200,177,206,170,2269,10,22690,841700612,78.49576704166857,78.49576704166857,-13,Feb_Demand,Dec_Demand,39,1.2294116923875475
784,ITM_785,History Cup,Home & Kitchen,198,228,200,198,201,204,205,202,205,198,205,208,2452,2,4904,841705516,78.49622438153037,78.49622438153037,10,Feb_Demand,Jan_Demand,30,1.1515150933578235
785,ITM_786,Feeling Become,Home & Kitchen,359,379,345,349,361,369,362,402,320,363,406,377,4392,2,8784,841714300,78.49704356451285,78.49704356451285,18,Nov_Demand,Sep_Demand,86,1.2687499603515637
786,ITM_787,Day Hot,Apparel,454,33,462,532,56,588,185,188,265,176,231,242,3412,2,6824,841721124,78.49767996076427,78.49767996076427,-212,Jun_Demand,Feb_Demand,555,17.818176418734417
787,ITM_788,Enter Eye,Grocery,3330,3629,3290,3127,3448,3253,3210,2986,3276,3415,3213,3094,39271,2,78542,841799666,78.50500467271895,78.50500467271895,-236,Feb_Demand,Aug_Demand,643,1.215338241073884
788,ITM_789,Low Necessary,Electronics,80,88,80,87,81,83,87,96,82,76,81,73,994,2,1988,841801654,78.50519007068904,78.50519007068904,-7,Aug_Demand,Dec_Demand,23,1.3150683130043406
789,ITM_790,Nor Party,Grocery,1124,1206,1260,823,1210,1291,1077,1409,1412,1165,1251,1180,14408,10,144080,841945734,78.51862676059294,78.51862676059294,56,Sep_Demand,Apr_Demand,589,1.7156743412433253
790,ITM_791,At Positive,Electronics,166,154,138,155,130,138,153,127,158,136,154,138,1747,50,87350,842033084,78.52677289373497,78.52677289373497,-28,Jan_Demand,Aug_Demand,39,1.3070865112530305
791,ITM_792,Can One,Electronics,185,178,190,177,175,187,188,197,192,226,178,186,2259,50,112950,842146034,78.53730644540519,78.53730644540519,1,Oct_Demand,May_Demand,51,1.2914284976326573
792,ITM_793,Within Really,Grocery,2461,2268,2107,2332,2453,2229,1880,2102,2062,1962,2017,2356,26229,2,52458,842198492,78.54219860170016,78.54219860170016,-105,Jan_Demand,Jul_Demand,581,1.3090425462284971
793,ITM_794,Admit Feeling,Apparel,431,595,786,791,624,730,557,546,713,229,455,228,6685,2,13370,842211862,78.54344546832992,78.54344546832992,-203,Apr_Demand,Dec_Demand,563,3.469298093451838
794,ITM_795,Front Big,Electronics,162,156,177,155,156,151,154,155,145,145,146,141,1843,10,18430,842230292,78.54516422315312,78.54516422315312,-21,Mar_Demand,Dec_Demand,36,1.2553190599064497
795,ITM_796,Far Would,Grocery,3646,3665,3868,3825,3769,3742,3841,3704,4023,3872,3789,3813,45557,50,2277850,844508142,78.75759317996594,78.75759317996594,167,Sep_Demand,Jan_Demand,377,1.1034009843571009
796,ITM_797,Admit Art,Grocery,1613,1776,1769,1271,1784,1597,1339,1036,1628,1309,1544,1687,18353,2,36706,844544848,78.76101632779779,78.76101632779779,74,May_Demand,Aug_Demand,748,1.722007705386026
797,ITM_798,Box Up,Grocery,2910,2682,2957,2907,2629,2894,3079,2823,2570,2754,3187,2881,34273,10,342730,844887578,78.79297882592911,78.79297882592911,-29,Nov_Demand,Sep_Demand,617,1.2400778161864676
798,ITM_799,Move Music,Home & Kitchen,132,167,141,139,130,146,143,162,152,149,153,121,1735,50,86750,844974328,78.80106900394941,78.80106900394941,-11,Feb_Demand,Dec_Demand,46,1.3801651751929607
799,ITM_800,Level Provide,Electronics,226,252,250,236,252,239,254,240,296,273,251,225,2994,2,5988,844980316,78.8016274360645,78.8016274360645,-1,Sep_Demand,Dec_Demand,71,1.3155554970864223
800,ITM_801,Law Where,Electronics,98,84,67,88,96,85,88,85,88,88,93,64,1024,2,2048,844982364,78.80181842954677,78.80181842954677,-34,Jan_Demand,Dec_Demand,34,1.5312497607422249
801,ITM_802,Strong Often,Grocery,2955,2628,3211,3166,3078,3463,3272,2948,3071,2999,3347,3070,37208,2,74416,845056780,78.80875835678086,78.80875835678086,115,Jun_Demand,Feb_Demand,835,1.3177321106631197
802,ITM_803,Blue Street,Toys,152,152,166,158,179,147,136,157,142,143,151,134,1817,1000,1817000,846873780,78.97820911715968,78.97820911715968,-18,May_Demand,Dec_Demand,45,1.335820795834269
803,ITM_804,At Hear,Electronics,494,508,498,498,486,507,463,494,503,487,531,467,5936,10,59360,846933140,78.98374494387188,78.98374494387188,-27,Nov_Demand,Jul_Demand,68,1.1468682257695848
804,ITM_805,Evening Table,Apparel,38,95,254,33,108,366,393,2,427,186,99,12,2013,2,4026,846937166,78.98412040273885,78.98412040273885,-26,Sep_Demand,Aug_Demand,425,213.49893250533748
805,ITM_806,Prove Lose,Grocery,4909,4611,4184,4644,4706,4669,4725,4991,4743,4412,4526,4445,55565,50,2778250,849715416,79.24321593109462,79.24321593109462,-464,Aug_Demand,Mar_Demand,807,1.1928776262120517
806,ITM_807,Out Fill,Grocery,2816,2518,2340,2677,2946,2602,2634,2590,2550,2576,2850,2514,31613,50,1580650,851296066,79.39062503642911,79.39062503642911,-302,May_Demand,Mar_Demand,606,1.2589743535941267
807,ITM_808,Subject Protect,Apparel,340,649,553,595,513,724,486,629,722,318,507,705,6741,2,13482,851309548,79.39188234801493,79.39188234801493,365,Jun_Demand,Oct_Demand,406,2.276729488153161
808,ITM_809,Age North,Apparel,105,367,419,320,166,466,11,77,504,354,387,60,3236,50,161800,851471348,79.4069715791813,79.4069715791813,-45,Sep_Demand,Jul_Demand,493,45.81814016532712
809,ITM_810,Herself General,Grocery,3294,3154,3277,3251,3249,3531,3469,3279,3372,2924,3170,3488,39458,2,78916,851550264,79.41433116982856,79.41433116982856,194,Jun_Demand,Oct_Demand,607,1.2075923351313531
810,ITM_811,Argue Though,Electronics,236,209,211,204,232,224,194,235,236,208,223,240,2652,2,5304,851555568,79.41482581310486,79.41482581310486,4,Dec_Demand,Jul_Demand,46,1.237113338293127
811,ITM_812,That Skin,Grocery,2416,2424,2539,2297,2168,2268,2054,2361,2350,2476,2322,2361,28036,50,1401800,852957368,79.5455556292298,79.5455556292298,-55,Mar_Demand,Jul_Demand,485,1.2361246288406784
812,ITM_813,Party To,Apparel,895,473,609,450,567,963,820,793,695,456,371,849,7941,100,794100,853751468,79.61961223287142,79.61961223287142,-46,Jun_Demand,Nov_Demand,592,2.595687261571772
813,ITM_814,Hot Forget,Grocery,2438,2039,2397,2651,2155,2059,2517,2030,2378,2135,2143,2215,27157,2,54314,853805782,79.62467747700967,79.62467747700967,-223,Apr_Demand,Aug_Demand,621,1.3059113236162003
814,ITM_815,Thing Three,Home & Kitchen,108,118,90,86,105,118,101,101,95,108,114,91,1235,2,2470,853808252,79.62490782559422,79.62490782559422,-17,Feb_Demand,Apr_Demand,32,1.3720928637101322
815,ITM_816,Court Child,Apparel,734,795,695,990,914,971,892,891,745,1102,1123,1025,10877,10,108770,853917022,79.6350515565829,79.6350515565829,291,Nov_Demand,Mar_Demand,428,1.6158273148801825
816,ITM_817,Former Between,Grocery,4795,5020,5078,4710,4281,4542,4937,4694,4361,5042,4740,4632,56832,100,5683200,859600222,80.16505846983819,80.16505846983819,-163,Mar_Demand,May_Demand,797,1.1861714524966798
817,ITM_818,Research Party,Electronics,187,197,185,184,176,194,200,153,164,155,171,185,2151,10,21510,859621732,80.16706446095307,80.16706446095307,-2,Jul_Demand,Aug_Demand,47,1.3071894570464406
818,ITM_819,West Way,Electronics,464,478,503,471,487,486,508,457,482,467,486,549,5838,50,291900,859913632,80.19428662768647,80.19428662768647,85,Dec_Demand,Aug_Demand,92,1.20131288399753
819,ITM_820,Together Executive,Apparel,1009,898,793,889,899,843,892,572,1051,984,1044,895,10769,2,21538,859935170,80.19629523004036,80.19629523004036,-114,Sep_Demand,Aug_Demand,479,1.8374125552899905
820,ITM_821,Appear Agree,Apparel,707,154,643,387,382,542,513,586,480,130,156,348,5028,10,50280,859985450,80.20098426924336,80.20098426924336,-359,Jan_Demand,Oct_Demand,577,5.438461120118375
821,ITM_822,Politics Financial,Grocery,1681,1901,1943,1401,1758,1483,1850,2016,1645,1803,1776,1501,20758,2,41516,860026966,80.2048559906346,80.2048559906346,-180,Aug_Demand,Apr_Demand,615,1.4389721524698633
822,ITM_823,Fast Down,Grocery,1721,2554,2249,2026,1797,1990,1859,2180,2288,2125,2098,1837,24724,10,247240,860274206,80.22791323113876,80.22791323113876,116,Feb_Demand,Jan_Demand,833,1.4840209094478738
823,ITM_824,Both Experience,Grocery,4886,4988,4512,4723,4837,5020,5275,4450,4590,4894,4830,4996,58001,2,116002,860390208,80.23873140786164,80.23873140786164,110,Jul_Demand,Aug_Demand,825,1.1853932557631612
824,ITM_825,True Successful,Electronics,92,79,116,80,68,100,83,73,80,84,93,68,1016,10,10160,860400368,80.23967891459002,80.23967891459002,-24,Mar_Demand,May_Demand,48,1.7058821020761614
825,ITM_826,Final Just,Electronics,245,261,258,274,234,252,251,268,246,268,273,300,3130,2,6260,860406628,80.24026271302698,80.24026271302698,55,Dec_Demand,May_Demand,66,1.282051227262768
826,ITM_827,Subject Matter,Toys,348,311,345,375,354,287,352,328,347,387,349,339,4122,2,8244,860414872,80.24103153639987,80.24103153639987,-9,Oct_Demand,Jun_Demand,100,1.3484320087654353
827,ITM_828,Door Animal,Toys,337,333,337,369,350,345,335,356,351,360,369,365,4207,2,8414,860423286,80.24181621372395,80.24181621372395,28,Apr_Demand,Feb_Demand,36,1.1081080748315895
828,ITM_829,Life Before,Toys,432,426,461,365,454,412,432,414,413,429,443,444,5125,10,51250,860474536,80.24659571370711,80.24659571370711,12,Mar_Demand,Apr_Demand,96,1.263013664027023
829,ITM_830,Word Radio,Grocery,1383,1472,1255,1453,1185,1338,1387,1672,1249,1368,1363,1560,16685,2,33370,860507906,80.249707751062,80.249707751062,177,Aug_Demand,May_Demand,487,1.4109704522280975
830,ITM_831,Race Certainly,Apparel,375,392,748,365,252,273,749,571,622,304,518,800,5969,2,11938,860519844,80.25082107146784,80.25082107146784,425,Dec_Demand,May_Demand,548,3.1746030486268633
831,ITM_832,None Well,Grocery,4261,4164,3967,4307,4724,4262,3831,4303,4009,4620,4132,3920,50500,10,505000,861024844,80.29791663227758,80.29791663227758,-341,May_Demand,Jul_Demand,893,1.2330984045077045
832,ITM_833,Effort Good,Toys,210,204,200,203,207,216,209,218,188,224,211,198,2488,100,248800,861273644,80.32111935609831,80.32111935609831,-12,Oct_Demand,Sep_Demand,36,1.1914892983250374
833,ITM_834,Research Turn,Grocery,4633,4369,4519,4702,4412,4615,4511,4700,5040,4553,4899,4697,55650,100,5565000,866838644,80.84010311036803,80.84010311036803,64,Sep_Demand,Feb_Demand,671,1.1535820527498695
834,ITM_835,Low Near,Toys,97,90,101,86,118,91,76,91,96,84,97,90,1117,10,11170,866849814,80.84114480821802,80.84114480821802,-7,May_Demand,Jul_Demand,42,1.5526313746537663
835,ITM_836,Strategy Concern,Grocery,4114,4045,4088,3896,3860,3916,4271,4094,3993,4012,3898,3866,48053,100,4805300,871655114,81.28928005249337,81.28928005249337,-248,Jul_Demand,May_Demand,411,1.1064766810713038
836,ITM_837,Affect Choose,Grocery,4190,4365,4161,4264,4535,4290,4139,4288,4518,4372,4290,4896,52308,2,104616,871759730,81.29903638752242,81.29903638752242,706,Dec_Demand,Jul_Demand,757,1.1828944160838502
837,ITM_838,Strong Picture,Toys,425,432,419,433,436,450,430,438,431,427,398,409,5128,10,51280,871811010,81.30381868526167,81.30381868526167,-16,Jun_Demand,Nov_Demand,52,1.1306532379232856
838,ITM_839,Measure Region,Apparel,283,196,421,65,200,214,309,520,154,603,611,266,3842,2,7684,871818694,81.30453528385426,81.30453528385426,-17,Nov_Demand,Apr_Demand,546,9.399998553846375
839,ITM_840,Group Hit,Apparel,286,689,314,776,863,837,554,298,330,489,521,881,6838,50,341900,872160594,81.33642037740051,81.33642037740051,595,Dec_Demand,Jan_Demand,595,3.080419472712606
840,ITM_841,American Way,Grocery,4415,4926,4714,4622,4801,4892,4949,4736,4568,4587,4634,4575,56419,2,112838,872273432,81.34694348411466,81.34694348411466,160,Jul_Demand,Jan_Demand,534,1.120951299839295
841,ITM_842,Development Rest,Grocery,1195,1000,1238,1135,1078,1083,1071,1227,940,826,992,1166,12951,100,1295100,873568532,81.46772261442099,81.46772261442099,-29,Mar_Demand,Oct_Demand,412,1.498789328101824
842,ITM_843,Myself Carry,Apparel,262,297,737,617,571,387,669,294,818,722,615,629,6618,2,13236,873581768,81.46895698440689,81.46895698440689,367,Sep_Demand,Jan_Demand,556,3.122137285414608
843,ITM_844,People Instead,Toys,233,232,228,222,248,240,239,228,270,225,252,235,2852,2,5704,873587472,81.4694889310977,81.4694889310977,2,Sep_Demand,Apr_Demand,48,1.2162161614317044
844,ITM_845,Might Issue,Grocery,3043,3356,3221,3028,2735,3204,3624,3096,3243,2828,3094,3359,37831,10,378310,873965782,81.50476956794905,81.50476956794905,316,Jul_Demand,May_Demand,889,1.3250456989943484
845,ITM_846,Any Best,Electronics,49,57,76,56,75,74,58,59,60,66,74,75,779,10,7790,873973572,81.5054960519465,81.5054960519465,26,Mar_Demand,Jan_Demand,27,1.5510200916285526
846,ITM_847,Store Itself,Electronics,202,179,187,177,202,187,187,201,212,213,169,157,2273,2,4546,873978118,81.50592000525232,81.50592000525232,-45,Oct_Demand,Dec_Demand,56,1.3566878116759356
847,ITM_848,Traditional Across,Electronics,367,374,343,357,400,398,376,375,363,405,409,329,4496,10,44960,874023078,81.51011290904243,81.51011290904243,-38,Nov_Demand,Dec_Demand,80,1.2431610564388738
848,ITM_849,Each People,Home & Kitchen,264,252,249,258,245,280,220,267,253,230,263,268,3049,2,6098,874029176,81.51068159959652,81.51068159959652,4,Jun_Demand,Jul_Demand,60,1.2727272148760356
849,ITM_850,Opportunity Rock,Grocery,4107,3918,4206,3963,4148,3872,4134,4179,4049,4213,4263,3933,48985,500,24492500,898521676,83.794816298869,83.794816298869,-174,Nov_Demand,Jun_Demand,391,1.100981402115234
850,ITM_851,Gun Paper,Home & Kitchen,385,348,358,394,370,381,423,389,422,369,373,367,4579,2,9158,898530834,83.79567036054402,83.79567036054402,-18,Jul_Demand,Feb_Demand,75,1.215517206450655
851,ITM_852,Material Leg,Grocery,4778,4604,4416,3917,4129,4293,4360,4378,4313,4265,4508,4683,52644,500,26322000,924852834,86.25042155189851,86.25042155189851,-95,Jan_Demand,Apr_Demand,861,1.2198110767939467
852,ITM_853,Call Condition,Electronics,226,203,188,194,190,212,209,190,193,199,196,203,2403,2,4806,924857640,86.25086975242377,86.25086975242377,-23,Jan_Demand,Mar_Demand,38,1.202127595631511
853,ITM_854,More Upon,Grocery,3585,3427,3256,3438,3482,3601,3360,3419,3082,3485,3306,3692,41133,10,411330,925268970,86.28922978614233,86.28922978614233,107,Dec_Demand,Sep_Demand,610,1.1979234224596904
854,ITM_855,Mother Data,Apparel,66,461,313,393,11,48,126,29,438,351,278,343,2857,10,28570,925297540,86.29189418252318,86.29189418252318,277,Feb_Demand,May_Demand,450,41.909052809951994
855,ITM_856,Policy Trial,Apparel,79,254,453,224,94,182,194,594,235,481,221,104,3115,50,155750,925453290,86.3064191995452,86.3064191995452,25,Aug_Demand,Jan_Demand,515,7.518986390001722
856,ITM_857,Order Beautiful,Home & Kitchen,366,410,389,389,396,373,355,399,386,354,371,362,4550,2,9100,925462390,86.30726785222514,86.30726785222514,-4,Feb_Demand,Oct_Demand,56,1.1581920576781906
857,ITM_858,Could Data,Grocery,2437,2169,2141,1685,2175,2174,2430,2288,1837,2012,2407,2039,25794,2,51588,925513978,86.31207887359356,86.31207887359356,-398,Jan_Demand,Apr_Demand,752,1.4462907926036155
858,ITM_859,Practice Direction,Grocery,3365,3849,3310,3453,3451,3678,3305,3181,3605,3007,3505,3457,41166,2,82332,925596310,86.31975703540066,86.31975703540066,92,Feb_Demand,Oct_Demand,842,1.2800132980378671
859,ITM_860,Scene Throughout,Grocery,4680,4711,4931,4643,4997,4534,4905,4817,4647,4832,5072,4747,57516,2,115032,925711342,86.33048475134336,86.33048475134336,67,Nov_Demand,Jun_Demand,538,1.118659018264978
860,ITM_861,To Yes,Electronics,239,240,254,264,239,257,224,273,262,255,275,262,3044,2,6088,925717430,86.3310525093121,86.3310525093121,23,Nov_Demand,Jul_Demand,51,1.2276785166214947
861,ITM_862,Nothing Role,Grocery,2330,2282,2151,2168,2262,2608,2625,2025,2431,2402,2241,2363,27888,10,278880,925996310,86.35706044990343,86.35706044990343,33,Jul_Demand,Aug_Demand,600,1.2962962898948331
862,ITM_863,Science Point,Electronics,346,335,325,325,346,307,343,300,322,360,331,313,3953,10,39530,926035840,86.36074695984166,86.36074695984166,-33,Oct_Demand,Aug_Demand,60,1.1999999600000015
863,ITM_864,Rise Maybe,Grocery,1130,1579,1697,1292,1321,1001,700,1180,1577,1371,1112,1598,15558,2,31116,926066956,86.36364879245583,86.36364879245583,468,Mar_Demand,Jul_Demand,997,2.4242856796530616
864,ITM_865,Physical Change,Grocery,3437,3613,3472,3465,3255,3560,3205,3310,3546,3626,3535,3318,41342,2,82684,926149640,86.3713597812677,86.3713597812677,-119,Oct_Demand,Jul_Demand,421,1.1313572507601957
865,ITM_866,Improve Us,Home & Kitchen,124,128,131,144,119,137,116,133,136,122,132,133,1555,2,3110,926152750,86.37164981531546,86.37164981531546,9,Apr_Demand,Jul_Demand,28,1.241379203329379
866,ITM_867,Economic All,Electronics,212,227,207,203,240,220,207,187,198,213,204,230,2548,100,254800,926407550,86.39541209035372,86.39541209035372,18,May_Demand,Aug_Demand,53,1.2834223912608347
867,ITM_868,Number Be,Home & Kitchen,173,226,181,192,195,207,197,212,202,209,188,200,2382,10,23820,926431370,86.39763350868736,86.39763350868736,27,Feb_Demand,Jan_Demand,53,1.3063583059908492
868,ITM_869,Always Far,Grocery,3835,3762,3982,3710,4258,4255,4191,3692,3745,3734,3416,3959,46539,2,93078,926524448,86.40631382672508,86.40631382672508,124,May_Demand,Nov_Demand,842,1.246487115788972
869,ITM_870,Respond Quickly,Apparel,1069,883,954,954,1010,689,1080,528,635,1005,1071,565,10443,50,522150,927046598,86.45500877143162,86.45500877143162,-504,Jul_Demand,Aug_Demand,552,2.045454506714877
870,ITM_871,Final Born,Toys,191,168,188,232,195,194,197,187,184,209,193,198,2336,2,4672,927051270,86.45544447531302,86.45544447531302,7,Apr_Demand,Feb_Demand,64,1.3809522987528393
871,ITM_872,Hand Dream,Apparel,475,479,554,607,275,697,273,425,535,541,591,806,6258,10,62580,927113850,86.46128059451198,86.46128059451198,331,Dec_Demand,Jul_Demand,533,2.952380844235134
872,ITM_873,Thing Author,Apparel,611,656,686,577,477,382,678,624,530,357,564,603,6745,2,13490,927127340,86.46253865216609,86.46253865216609,-8,Mar_Demand,Oct_Demand,329,1.9215685736255304
873,ITM_874,Factor Rest,Apparel,153,87,2,124,184,86,371,29,403,22,127,4,1592,50,79600,927206940,86.46996203165213,86.46996203165213,-149,Sep_Demand,Mar_Demand,401,201.49899250503748
874,ITM_875,Though Notice,Grocery,3051,2504,2796,3004,2329,2478,2478,2749,2812,3198,2671,2730,32800,100,3280000,930486940,86.77585003057482,86.77585003057482,-321,Oct_Demand,May_Demand,869,1.373121505482518
875,ITM_876,Inside Paper,Electronics,171,195,180,157,167,187,185,178,198,180,167,171,2136,2,4272,930491212,86.7762484310417,86.7762484310417,0,Sep_Demand,Apr_Demand,41,1.2611464164874893
876,ITM_877,Interest Discover,Grocery,3100,3193,3093,3437,3209,2935,3138,3270,3261,3131,3483,3357,38607,10,386070,930877282,86.8122527541344,86.8122527541344,257,Nov_Demand,Jun_Demand,548,1.1867120913570286
877,ITM_878,Nothing Entire,Grocery,1563,1718,1716,1947,1601,1881,1718,1801,1828,1567,1534,1750,20624,2,41248,930918530,86.81609948223793,86.81609948223793,187,Apr_Demand,Nov_Demand,413,1.2692307609567748
878,ITM_879,Follow Author,Apparel,813,922,1123,1092,1206,674,1054,1165,987,1037,757,1047,11877,10,118770,931037300,86.82717579858917,86.82717579858917,234,May_Demand,Jun_Demand,532,1.7893174808706607
879,ITM_880,Traditional Avoid,Grocery,1716,1489,1539,1809,1612,1655,1685,1452,1712,1800,1788,1663,19920,10,199200,931236500,86.84575289901154,86.84575289901154,-53,Apr_Demand,Aug_Demand,357,1.2458677600146848
880,ITM_881,So Computer,Apparel,291,672,273,456,567,434,285,287,371,352,447,581,5016,10,50160,931286660,86.85043074719019,86.85043074719019,290,Feb_Demand,Mar_Demand,399,2.461538371372221
881,ITM_882,Level Share,Grocery,3846,3544,3790,3832,3914,3935,3604,4004,3509,3695,3713,3883,45269,100,4526900,935813560,87.27260281497162,87.27260281497162,37,Aug_Demand,Sep_Demand,495,1.1410658274691767
882,ITM_883,Expect Region,Grocery,3358,3612,3371,3579,3418,3414,3262,3595,3434,3358,3225,3426,41052,2,82104,935895664,87.28025971383245,87.28025971383245,68,Feb_Demand,Nov_Demand,387,1.1199999965271317
883,ITM_884,Sing Room,Grocery,3667,4044,3934,3941,4132,3686,4009,4066,4036,3857,4110,4085,47567,10,475670,936371334,87.32462000177378,87.32462000177378,418,May_Demand,Jan_Demand,465,1.126806650867721
884,ITM_885,Easy Feel,Grocery,2094,1998,1888,1664,1666,1716,1787,1589,1849,1828,1975,1972,22026,2,44052,936415386,87.32872822681297,87.32872822681297,-122,Jan_Demand,Aug_Demand,505,1.3178099350672754
885,ITM_886,Forget Term,Home & Kitchen,82,61,62,68,66,65,68,82,69,71,73,52,819,10,8190,936423576,87.32949201422491,87.32949201422491,-30,Jan_Demand,Dec_Demand,30,1.5769227736686973
886,ITM_887,Consumer Big,Electronics,61,74,66,73,88,74,82,77,85,98,78,87,943,10,9430,936433006,87.33037144222182,87.33037144222182,26,Oct_Demand,Jan_Demand,37,1.6065571136791617
887,ITM_888,Instead Nearly,Apparel,876,829,833,765,519,553,394,451,378,559,676,336,7169,10,71690,936504696,87.33705714668608,87.33705714668608,-540,Jan_Demand,Dec_Demand,540,2.607142779549322
888,ITM_889,Hundred Sort,Apparel,341,346,325,424,288,355,288,343,113,472,417,478,4190,2,8380,936513076,87.3378386532199,87.3378386532199,137,Dec_Demand,Sep_Demand,365,4.230088121231139
889,ITM_890,World Education,Grocery,2183,2038,2006,1679,1762,1825,2433,2255,2115,1798,1650,2300,24044,10,240440,936753516,87.36026173567751,87.36026173567751,117,Jul_Demand,Nov_Demand,783,1.4745454456088154
890,ITM_891,Gas Word,Apparel,814,385,432,706,519,337,439,556,372,743,307,386,5996,10,59960,936813476,87.36585351751148,87.36585351751148,-428,Jan_Demand,Nov_Demand,507,2.6514657116786413
891,ITM_892,Expert Could,Apparel,404,455,986,605,486,589,961,552,858,709,693,560,7858,2,15716,936829192,87.3673191686673,87.3673191686673,156,Mar_Demand,Jan_Demand,582,2.4405939989951984
892,ITM_893,Hold After,Apparel,835,504,1016,1032,775,695,825,945,778,865,772,743,9785,10,97850,936927042,87.37644451644003,87.37644451644003,-92,Apr_Demand,Feb_Demand,528,2.0476190069916864
893,ITM_894,Production Star,Grocery,1727,1662,1694,1488,1082,1332,1546,1106,949,1597,1440,1501,17124,2,34248,936961290,87.37963843478975,87.37963843478975,-226,Jan_Demand,Sep_Demand,778,1.8198103074835585
894,ITM_895,Game Tonight,Apparel,1071,997,668,969,851,646,854,541,871,945,939,564,9916,10,99160,937060450,87.388885951245,87.388885951245,-507,Jan_Demand,Aug_Demand,530,1.9796672462168716
895,ITM_896,School Entire,Grocery,3414,3090,3003,3145,2903,2851,3231,3195,3144,3476,2814,3116,37382,10,373820,937434270,87.42374785726855,87.42374785726855,-298,Oct_Demand,Nov_Demand,662,1.2352523054895084
896,ITM_897,Sense Investment,Grocery,2328,2180,2144,1994,1936,2053,2029,1938,2096,2329,1655,2278,24960,2,49920,937484190,87.4284033233985,87.4284033233985,-50,Oct_Demand,Nov_Demand,674,1.4072507467839834
897,ITM_898,Pass Financial,Electronics,164,173,186,181,164,157,167,148,177,161,178,200,2056,2,4112,937488302,87.42878680249959,87.42878680249959,36,Dec_Demand,Aug_Demand,52,1.3513512600438338
898,ITM_899,Maybe Election,Toys,460,415,425,449,434,428,409,446,417,448,446,419,5196,2,10392,937498694,87.42975594520837,87.42975594520837,-41,Jan_Demand,Jul_Demand,51,1.124694349029478
899,ITM_900,Daughter Energy,Grocery,2575,2353,2606,2405,2647,2296,2707,2435,2533,2490,2454,2371,29872,10,298720,937797414,87.45761413515903,87.45761413515903,-204,Jul_Demand,Jun_Demand,411,1.1790069635060672
900,ITM_901,Full Article,Grocery,3675,4058,3408,3499,3479,3499,3768,3704,3777,3623,3531,3769,43790,50,2189500,939986914,87.66180370029355,87.66180370029355,94,Feb_Demand,Mar_Demand,650,1.1907276960365971
901,ITM_902,Record Eight,Grocery,2805,2181,2398,2265,2324,2134,2632,2127,2140,2279,2368,2367,28020,2,56040,940042954,87.66702990866538,87.66702990866538,-438,Jan_Demand,Aug_Demand,678,1.3187588090326336
902,ITM_903,Term Me,Electronics,440,504,485,430,449,500,423,485,443,495,453,413,5520,10,55200,940098154,87.67217777986677,87.67217777986677,-27,Feb_Demand,Dec_Demand,91,1.220338953502689
903,ITM_904,Week Gas,Home & Kitchen,176,157,152,153,150,156,179,155,162,171,155,161,1927,2,3854,940102008,87.6725371982655,87.6725371982655,-15,Jul_Demand,May_Demand,29,1.193333253777783
904,ITM_905,Between Start,Electronics,509,456,488,498,519,498,491,481,460,503,478,506,5887,50,294350,940396358,87.69998784841273,87.69998784841273,-3,May_Demand,Feb_Demand,63,1.1381578697772397
905,ITM_906,Bank Hot,Grocery,2541,2231,2356,2137,2268,2356,2050,1672,2080,2096,2188,2276,26251,500,13125500,953521858,88.92405276605285,88.92405276605285,-265,Jan_Demand,Aug_Demand,869,1.519736833015928
906,ITM_907,Gun Both,Electronics,57,58,49,44,61,48,37,36,47,69,48,60,614,2,1228,953523086,88.92416728753537,88.92416728753537,3,Oct_Demand,Aug_Demand,33,1.916666134259407
907,ITM_908,Moment Religious,Apparel,959,936,780,1085,1274,1005,713,778,951,1143,1148,799,11571,100,1157100,954680186,89.03207673983825,89.03207673983825,-160,May_Demand,Jul_Demand,561,1.7868162442241762
908,ITM_909,Body Trial,Grocery,4899,4842,4784,4720,4633,4894,4425,4913,4669,4847,5101,4973,57700,2,115400,954795586,89.04283877492229,89.04283877492229,74,Nov_Demand,Jul_Demand,676,1.1527683589767947
909,ITM_910,Attack Serve,Grocery,3399,3811,3648,3034,3473,3050,3454,3201,3309,3131,3378,3557,40445,10,404450,955200036,89.0805571899114,89.0805571899114,158,Feb_Demand,Apr_Demand,777,1.2560975568355386
910,ITM_911,Animal Morning,Apparel,284,287,307,506,121,581,213,556,2,236,388,254,3735,100,373500,955573536,89.11538925320336,89.11538925320336,-30,Jun_Demand,Sep_Demand,579,290.49854750726246
911,ITM_912,Only Wall,Grocery,2476,2511,2957,2415,2431,2836,2790,2332,2672,3056,2964,2727,32167,2,64334,955637870,89.12138894787492,89.12138894787492,251,Oct_Demand,Aug_Demand,724,1.3104631161643947
912,ITM_913,Front Agency,Home & Kitchen,448,450,451,461,434,439,458,420,454,413,409,466,5303,2,10606,955648476,89.12237804791046,89.12237804791046,18,Dec_Demand,Nov_Demand,57,1.139364275321167
913,ITM_914,Rest Work,Toys,311,274,289,314,294,329,305,276,301,304,325,293,3615,2,7230,955655706,89.1230523071276,89.1230523071276,-18,Jun_Demand,Feb_Demand,55,1.2007298831850408
914,ITM_915,Institution After,Grocery,5061,4806,5180,4663,4409,4463,4708,4615,4294,4906,5002,4731,56838,2,113676,955769382,89.13365356449513,89.13365356449513,-330,Mar_Demand,Sep_Demand,886,1.2063344173117503
915,ITM_916,Give Keep,Apparel,630,580,890,864,582,957,788,1090,814,646,603,536,8980,2,17960,955787342,89.1353284878063,89.1353284878063,-94,Aug_Demand,Dec_Demand,554,2.0335820516122753
916,ITM_917,Kind Not,Home & Kitchen,193,172,194,193,192,215,203,187,206,219,203,181,2358,10,23580,955810922,89.13752752409124,89.13752752409124,-12,Oct_Demand,Feb_Demand,47,1.273255739926992
917,ITM_918,Family Month,Grocery,2966,2816,2996,3321,3193,3088,2772,3148,2946,2900,3292,2980,36418,100,3641800,959452722,89.47715646143168,89.47715646143168,14,Apr_Demand,Jul_Demand,549,1.1980519437299713
918,ITM_919,Feel Technology,Electronics,155,151,151,152,172,130,170,134,145,158,150,135,1803,2,3606,959456328,89.47749275171341,89.47749275171341,-20,May_Demand,Jun_Demand,42,1.323076821301783
919,ITM_920,Affect Data,Grocery,3349,3122,3252,3040,3123,2816,3129,3157,3339,3246,3102,3316,37991,100,3799100,963255428,89.83179125680705,89.83179125680705,-33,Jan_Demand,Jun_Demand,533,1.1892755639585384
920,ITM_921,Wide War,Home & Kitchen,174,179,177,207,173,196,197,165,220,187,183,165,2223,100,222300,963477728,89.85252262941697,89.85252262941697,-9,Sep_Demand,Aug_Demand,55,1.3333332525252575
921,ITM_922,Word Hope,Grocery,4622,4167,4427,4428,4395,4398,4220,4184,4043,4422,4235,4273,51814,2,103628,963581356,89.8621868250122,89.8621868250122,-349,Jan_Demand,Sep_Demand,579,1.143210484434305
922,ITM_923,Represent Size,Home & Kitchen,225,232,200,212,219,233,216,213,227,217,222,230,2646,10,26460,963607816,89.86465444588156,89.86465444588156,5,Jun_Demand,Mar_Demand,33,1.164999941750003
923,ITM_924,Course Response,Apparel,354,409,152,581,596,253,224,306,336,278,131,423,4043,10,40430,963648246,89.86842488850243,89.86842488850243,69,May_Demand,Nov_Demand,465,4.549617973311605
924,ITM_925,Ten And,Grocery,4991,4663,5068,4885,5127,4705,5130,5129,5127,4840,4774,5023,59462,1000,59462000,1023110246,95.41376397141103,95.41376397141103,32,Jul_Demand,Feb_Demand,467,1.1001501155904996
925,ITM_926,Research True,Home & Kitchen,345,325,351,348,352,331,327,348,318,370,338,372,4125,100,412500,1023522746,95.45223311761701,95.45223311761701,27,Dec_Demand,Sep_Demand,54,1.1698112839681987
926,ITM_927,Professional Claim,Electronics,364,357,339,406,362,349,360,346,328,355,341,350,4257,10,42570,1023565316,95.45620313350547,95.45620313350547,-14,Apr_Demand,Sep_Demand,78,1.2378048403108282
927,ITM_928,Kind Cost,Grocery,3842,4054,3943,3678,4024,3825,4186,3783,4103,3957,4039,4000,47434,50,2371700,1025937016,95.677384403946,95.677384403946,158,Jul_Demand,Apr_Demand,508,1.1381185395918474
928,ITM_929,Company Civil,Grocery,3263,3035,3070,3233,3167,3300,3043,3285,3502,3012,3362,3651,38923,10,389230,1026326246,95.71368342401327,95.71368342401327,388,Dec_Demand,Oct_Demand,639,1.2121513903979038
929,ITM_930,Notice Sometimes,Grocery,3408,3411,3482,3800,3395,3326,3520,3781,3844,3320,3705,3249,42241,2,84482,1026410728,95.72156209167333,95.72156209167333,-159,Sep_Demand,Dec_Demand,595,1.1831332681344005
930,ITM_931,Account West,Grocery,2486,2801,3056,2539,2565,3226,3046,2852,2991,2882,2687,3206,34337,10,343370,1026754098,95.75358427526787,95.75358427526787,720,Jun_Demand,Jan_Demand,740,1.2976669296151773
931,ITM_932,Early Arrive,Apparel,750,811,586,861,888,625,1027,662,461,447,483,497,8098,2,16196,1026770294,95.75509469052108,95.75509469052108,-253,Jul_Demand,Oct_Demand,580,2.2975390984890582
932,ITM_933,Fly Style,Grocery,3478,3299,3730,3638,3239,3410,3535,3519,3571,3603,3756,3631,42409,2,84818,1026855112,95.76300469304933,95.76300469304933,153,Nov_Demand,May_Demand,517,1.1596171622117406
933,ITM_934,Sort Book,Electronics,108,96,105,95,112,99,104,106,109,87,112,89,1222,100,122200,1026977312,95.77440088617992,95.77440088617992,-19,May_Demand,Oct_Demand,25,1.2873561738671064
934,ITM_935,Claim Rest,Grocery,2260,2257,2615,2305,2372,2820,2619,2356,1997,2365,2398,2290,28654,10,286540,1027263852,95.80112318715896,95.80112318715896,30,Jun_Demand,Sep_Demand,823,1.4121181701947012
935,ITM_936,Brother Worker,Electronics,477,467,476,450,453,483,451,482,437,434,462,471,5543,2,11086,1027274938,95.80215705129191,95.80215705129191,-6,Jun_Demand,Oct_Demand,49,1.1129032001635208
936,ITM_937,Lawyer Sing,Grocery,2742,2514,2799,2984,2979,3137,2794,2898,2842,2885,2787,2181,33542,10,335420,1027610358,95.8334378295232,95.8334378295232,-561,Jun_Demand,Dec_Demand,956,1.4383310342121456
937,ITM_938,Compare Pick,Home & Kitchen,134,124,108,106,133,125,119,97,116,109,125,124,1420,10,14200,1027624558,95.83476210073806,95.83476210073806,-10,Jan_Demand,Aug_Demand,37,1.3814431565522518
938,ITM_939,Admit Forward,Grocery,2276,2439,2471,1948,2398,2404,2354,2371,2302,1640,2180,2173,26956,2,53912,1027678470,95.83978985494474,95.83978985494474,-103,Mar_Demand,Oct_Demand,831,1.506707307885931
939,ITM_940,Middle Campaign,Apparel,227,98,579,266,562,599,197,609,454,335,542,201,4669,10,46690,1027725160,95.84414409600258,95.84414409600258,-26,Aug_Demand,Feb_Demand,511,6.214285080174991
940,ITM_941,Anyone Option,Grocery,2028,2023,2036,2156,2332,1933,2036,2358,2192,2206,1926,2205,25431,10,254310,1027979470,95.86786067435807,95.86786067435807,177,Aug_Demand,Nov_Demand,432,1.2242990590638678
941,ITM_942,Technology Condition,Apparel,378,413,532,48,146,154,325,344,495,240,412,114,3601,2,7202,1027986672,95.8685323223362,95.8685323223362,-264,Mar_Demand,Apr_Demand,484,11.083331024306036
942,ITM_943,Letter Often,Electronics,395,451,432,450,450,417,434,440,456,435,451,444,5255,2,10510,1027997182,95.86951246955225,95.86951246955225,49,Sep_Demand,Jan_Demand,61,1.1544303505207507
943,ITM_944,Project Up,Apparel,579,444,184,43,452,403,332,398,128,151,455,480,4049,100,404900,1028402082,95.90727285088268,95.90727285088268,-99,Jan_Demand,Apr_Demand,536,13.465113147648104
944,ITM_945,Team Experience,Apparel,421,452,748,666,285,584,226,666,556,460,181,477,5722,100,572200,1028974282,95.96063538532889,95.96063538532889,56,Mar_Demand,Nov_Demand,567,4.132596456762626
945,ITM_946,Tonight Attack,Electronics,223,194,225,213,206,207,220,212,212,212,217,233,2574,2,5148,1028979430,95.96111548027353,95.96111548027353,10,Dec_Demand,Feb_Demand,39,1.201030865926244
946,ITM_947,Class Now,Grocery,4776,4573,4617,4590,4420,4659,4707,4610,4644,4319,4591,5009,55515,10,555150,1029534580,96.01288795667656,96.01288795667656,233,Dec_Demand,Oct_Demand,690,1.1597592008340838
947,ITM_948,Woman Good,Apparel,678,1155,790,692,1107,868,1123,683,647,1043,750,1069,10605,2,21210,1029555790,96.01486597023057,96.01486597023057,391,Feb_Demand,Sep_Demand,508,1.7851622598893004
948,ITM_949,Do Coach,Grocery,3815,3854,3985,3506,3777,3916,3629,3655,4039,3416,3658,3895,45145,10,451450,1030007240,96.05696753642376,96.05696753642376,80,Sep_Demand,Oct_Demand,623,1.1823770457190368
949,ITM_950,Maintain Home,Toys,504,493,469,478,466,440,458,458,483,489,487,444,5669,2,11338,1030018578,96.05802490170784,96.05802490170784,-60,Jan_Demand,Jun_Demand,64,1.1454545194214882
950,ITM_951,Trip Next,Electronics,191,191,193,208,196,179,202,202,206,193,197,221,2379,500,1189500,1031208078,96.16895593058544,96.16895593058544,30,Dec_Demand,Jun_Demand,42,1.234636802534257
951,ITM_952,Yes Try,Apparel,802,1048,1101,1214,924,879,1211,1158,1230,796,873,1088,12324,10,123240,1031331318,96.18044911259373,96.18044911259373,286,Sep_Demand,Oct_Demand,434,1.545226111240878
952,ITM_953,Modern Animal,Apparel,484,486,162,183,410,90,271,22,546,421,397,169,3641,2,7282,1031338600,96.18112822125475,96.18112822125475,-315,Sep_Demand,Aug_Demand,524,24.81817053719521
953,ITM_954,Opportunity Thousand,Apparel,227,265,75,378,329,377,11,283,402,183,445,268,3243,50,162150,1031500750,96.19625009290881,96.19625009290881,41,Nov_Demand,Jul_Demand,434,40.45450867771939
954,ITM_955,Improve Officer,Apparel,215,243,158,73,200,366,54,317,212,30,114,349,2331,100,233100,1031733850,96.21798865771031,96.21798865771031,134,Jun_Demand,Oct_Demand,336,12.199995933334689
955,ITM_956,Population Lead,Electronics,489,447,525,436,498,460,468,464,493,468,503,486,5737,2,11474,1031745324,96.21905870615531,96.21905870615531,-3,Mar_Demand,Apr_Demand,89,1.2041284127493483
956,ITM_957,Charge Office,Home & Kitchen,92,96,93,80,89,102,87,86,94,96,99,92,1106,10,11060,1031756384,96.22009014556632,96.22009014556632,0,Jun_Demand,Apr_Demand,22,1.2749998406250198
957,ITM_958,Six Staff,Apparel,345,584,501,96,352,600,190,551,671,471,494,564,5419,10,54190,1031810574,96.22514382564609,96.22514382564609,219,Sep_Demand,Apr_Demand,575,6.989582605251812
958,ITM_959,Field Service,Grocery,4824,4791,4560,4642,4468,4532,4539,4570,4745,4914,4688,4675,55948,2,111896,1031922470,96.23557908281909,96.23557908281909,-149,Oct_Demand,May_Demand,446,1.0998209465089057
959,ITM_960,Shake Manage,Electronics,101,105,89,88,98,78,90,91,93,103,92,76,1104,50,55200,1031977670,96.24072695402046,96.24072695402046,-25,Feb_Demand,Dec_Demand,29,1.3815787655817413
960,ITM_961,Hair Hospital,Home & Kitchen,220,213,222,207,215,242,220,217,209,213,215,224,2617,10,26170,1032003840,96.2431675299143,96.2431675299143,4,Jun_Demand,Apr_Demand,35,1.16908206912647
961,ITM_962,Scene Fish,Grocery,3610,3346,3254,3142,3792,3388,3602,3464,3374,3412,3754,3214,41352,2,82704,1032086544,96.2508803838969,96.2508803838969,-396,May_Demand,Apr_Demand,650,1.2068745983231235
962,ITM_963,Night Why,Apparel,544,816,639,327,775,492,731,806,309,759,730,355,7283,10,72830,1032159374,96.25767240309249,96.25767240309249,-189,Feb_Demand,Sep_Demand,507,2.6407766135671
963,ITM_964,Then Force,Apparel,37,73,329,111,239,77,424,427,108,326,146,99,2396,50,119800,1032279174,96.26884477573607,96.26884477573607,62,Aug_Demand,Jan_Demand,390,11.54053742147637
964,ITM_965,Physical Child,Home & Kitchen,154,129,153,143,161,156,149,147,132,137,167,145,1773,2,3546,1032282720,96.26917547050563,96.26917547050563,-9,Nov_Demand,Feb_Demand,38,1.2945735430563146
965,ITM_966,Mention Teach,Toys,284,311,311,291,334,323,322,303,338,277,302,349,3745,50,187250,1032469970,96.28663813141975,96.28663813141975,65,Dec_Demand,Oct_Demand,72,1.2599277523491788
966,ITM_967,Almost Million,Apparel,899,720,760,469,488,799,540,563,536,979,722,956,8431,2,16862,1032486832,96.28821065685811,96.28821065685811,57,Oct_Demand,Apr_Demand,510,2.0874199981360344
967,ITM_968,Star Sense,Electronics,252,238,236,223,232,241,226,238,213,271,248,220,2838,10,28380,1032515212,96.29085733411708,96.29085733411708,-32,Oct_Demand,Sep_Demand,58,1.2723004097511545
968,ITM_969,Issue Technology,Electronics,442,416,405,438,448,408,418,388,427,422,423,399,5034,2,10068,1032525280,96.29179626106011,96.29179626106011,-43,May_Demand,Aug_Demand,60,1.1546391454989913
969,ITM_970,Guy Year,Grocery,1982,2173,2085,1567,2039,1899,2011,1989,2249,2062,2035,2449,24540,10,245400,1032770680,96.31468190585755,96.31468190585755,467,Dec_Demand,Apr_Demand,882,1.5628589562038357
970,ITM_971,Marriage Debate,Grocery,2217,2064,2356,1778,2214,2179,2123,2032,1437,2009,2378,2207,24994,500,12497000,1045267680,97.48013383346021,97.48013383346021,-10,Nov_Demand,Sep_Demand,941,1.6548364533414304
971,ITM_972,Oil Wear,Electronics,416,406,401,366,424,403,413,391,395,386,389,399,4789,2,9578,1045277258,97.48102706372048,97.48102706372048,-17,May_Demand,Apr_Demand,58,1.158469913703008
972,ITM_973,Population Figure,Apparel,206,338,92,529,38,88,43,11,494,26,26,495,2386,10,23860,1045301118,97.48325221239557,97.48325221239557,289,Apr_Demand,Aug_Demand,518,48.09086537194057
973,ITM_974,Difference Leg,Electronics,43,64,52,79,60,59,53,61,65,54,63,66,719,10,7190,1045308308,97.48392274127126,97.48392274127126,23,Apr_Demand,Jan_Demand,36,1.8372088750677034
974,ITM_975,Court Significant,Apparel,106,8,46,107,476,258,133,145,415,110,358,343,2505,2,5010,1045313318,97.4843899665379,97.4843899665379,237,May_Demand,Feb_Demand,468,59.49992562509297
975,ITM_976,Smile Maybe,Electronics,329,345,314,329,351,339,325,327,320,288,328,338,3933,100,393300,1045706618,97.52106854884775,97.52106854884775,9,May_Demand,Oct_Demand,63,1.2187499576822933
976,ITM_977,Method Open,Grocery,2461,2528,2156,2751,2432,2571,2731,2401,2370,2492,2687,2302,29882,10,298820,1046005438,97.54893606465204,97.54893606465204,-159,Apr_Demand,Mar_Demand,595,1.275974020055779
977,ITM_978,Same Matter,Grocery,1862,2000,2023,2120,1942,1777,1857,2208,1604,1888,2222,2245,23748,50,1187400,1047192838,97.6596712506035,97.6596712506035,383,Dec_Demand,Sep_Demand,641,1.3996259264362474
978,ITM_979,It Audience,Grocery,2776,2679,2721,2696,2699,2449,2215,2477,2571,2750,2798,2655,31486,2,62972,1047255810,97.66554392714868,97.66554392714868,-121,Nov_Demand,Jul_Demand,583,1.2632054119042644
979,ITM_980,Stuff When,Home & Kitchen,96,97,104,87,111,110,103,86,98,116,85,96,1189,2,2378,1047258188,97.66576569594788,97.66576569594788,0,Oct_Demand,Nov_Demand,31,1.3647057217993268
980,ITM_981,Front Practice,Grocery,1744,1951,1857,1911,2004,1789,1700,1853,1835,1561,1724,1755,21684,10,216840,1047475028,97.68598787694984,97.68598787694984,11,May_Demand,Oct_Demand,443,1.2837924325189467
981,ITM_982,Authority Instead,Grocery,1296,1125,1384,1153,1223,1110,1401,1464,1404,1230,1340,1202,15332,10,153320,1047628348,97.70028627572874,97.70028627572874,-94,Aug_Demand,Jun_Demand,354,1.3189189070367666
982,ITM_983,Test Six,Electronics,430,421,436,432,452,439,478,501,454,468,468,513,5492,50,274600,1047902948,97.7258950697849,97.7258950697849,83,Dec_Demand,Feb_Demand,92,1.2185272869708483
983,ITM_984,Expert Politics,Grocery,2756,3212,2726,2302,2803,2215,2689,2663,3082,2490,2566,2655,32159,100,3215900,1051118848,98.02580519653351,98.02580519653351,-101,Feb_Demand,Jun_Demand,997,1.4501128602703708
984,ITM_985,Year Rest,Toys,268,334,315,309,296,269,313,318,310,318,282,284,3616,100,361600,1051480448,98.05952748324401,98.05952748324401,16,Feb_Demand,Jan_Demand,66,1.246268610213858
985,ITM_986,Public By,Apparel,1188,1108,1152,908,1240,714,1129,1153,1191,847,907,1241,12778,500,6389000,1057869448,98.65535627138942,98.65535627138942,53,Dec_Demand,Jun_Demand,527,1.738095213752168
986,ITM_987,Remain End,Grocery,3053,3263,3210,2863,3054,2779,2701,2944,2823,3283,3284,2976,36233,2,72466,1057941914,98.66211434447783,98.66211434447783,-77,Nov_Demand,Jul_Demand,583,1.2158459784678044
987,ITM_988,Fill Success,Apparel,823,923,1124,970,762,863,960,900,879,731,1068,1001,11004,500,5502000,1063443914,99.17522281096336,99.17522281096336,178,Mar_Demand,Oct_Demand,393,1.5376196780079388
988,ITM_989,Common Television,Electronics,144,172,151,181,171,197,165,143,183,183,165,143,1998,2,3996,1063447910,99.17559547207425,99.17559547207425,-1,Jun_Demand,Aug_Demand,54,1.377622281285155
989,ITM_990,Light Sport,Grocery,4815,5067,4966,5089,4878,4726,4969,4904,5240,4963,4968,5054,59639,10,596390,1064044300,99.23121393051251,99.23121393051251,239,Sep_Demand,Jun_Demand,514,1.1087600484368176
990,ITM_991,Whole Type,Grocery,2039,1691,2094,1754,2032,1829,1702,1485,1907,1839,2024,1962,22358,10,223580,1064267880,99.25206467404882,99.25206467404882,-77,Mar_Demand,Aug_Demand,609,1.4101010006053805
991,ITM_992,Network Pick,Electronics,265,262,266,230,223,256,240,238,234,264,234,230,2942,10,29420,1064297300,99.2548083401855,99.2548083401855,-35,Mar_Demand,May_Demand,43,1.1928250586177103
992,ITM_993,Catch Contain,Home & Kitchen,68,80,83,90,84,92,81,78,70,85,75,83,969,2,1938,1064299238,99.25498907522876,99.25498907522876,15,Jun_Demand,Jan_Demand,24,1.3529409775086798
993,ITM_994,Say Medical,Apparel,786,713,1069,1012,732,1217,987,963,916,798,728,872,10793,500,5396500,1069695738,99.7582587661392,99.7582587661392,86,Jun_Demand,Feb_Demand,504,1.7068723463271762
994,ITM_995,Street Others,Grocery,2362,2603,2531,2447,2433,2457,2647,2284,2271,2418,2378,2330,29161,10,291610,1069987348,99.78545388789709,99.78545388789709,-32,Jul_Demand,Sep_Demand,376,1.165565824898433
995,ITM_996,No Join,Grocery,4159,4152,3776,4189,4123,4080,4306,4287,3793,3989,4183,4218,49255,2,98510,1070085858,99.79464078630376,99.79464078630376,59,Jul_Demand,Mar_Demand,530,1.1403601664715037
996,ITM_997,Adult Meeting,Grocery,3357,3516,3102,3329,3068,3130,3443,3473,3637,3057,3556,3021,39689,50,1984450,1072070308,99.97970768857878,99.97970768857878,-336,Sep_Demand,Dec_Demand,616,1.2039059874084541
997,ITM_998,Agent Nature,Apparel,69,136,107,306,66,202,269,349,3,307,89,46,1949,2,3898,1072074206,99.98007121035312,99.98007121035312,-23,Aug_Demand,Sep_Demand,346,116.33294555684814
998,ITM_999,Follow Believe,Home & Kitchen,322,357,342,361,365,330,329,326,337,351,350,341,4111,50,205550,1072279756,99.99924050248072,99.99924050248072,19,May_Demand,Jan_Demand,43,1.1335403374676916
999,ITM_1000,Table Actually,Toys,357,378,351,362,330,352,312,337,327,299,336,331,4072,2,8144,1072287900,100.0,100.0,-26,Feb_Demand,Oct_Demand,79,1.2642140045413377
